name,generalization_nodes,generalization_edges,generalization_node_variables,generalization_edge_variables,g1_nodes,g1_edges,g2_nodes,g2_edges,time,nodes,edges,nodes^2,nodes^3,edges^2,nodesXedges
0,35,27,11,22,72,71,171,170,90,243,241,12312,1495908.0,12070,14640.75
1,59,48,18,38,131,130,124,123,124,255,253,16244,2071110.0,15990,16128.75
10,80,72,22,36,137,136,229,228,189,366,364,31373,5741259.0,31008,33306.0
1000,63,55,17,31,116,115,151,150,130,267,265,17516,2338386.0,17250,17688.75
1001,39,30,13,23,230,229,109,108,221,339,337,25070,4249365.0,24732,28560.75
1002,34,29,12,19,112,111,146,145,95,258,256,16352,2109408.0,16095,16512.0
1003,102,86,34,64,329,328,267,266,941,596,594,87843,26177214.0,87248,88506.0
1004,68,58,22,36,181,180,144,143,209,325,323,26064,4235400.0,25740,26243.75
1006,36,32,9,14,122,121,121,120,76,243,241,14762,1793583.0,14520,14640.75
1007,41,35,9,18,107,106,111,110,74,218,216,11877,1294593.0,11660,11772.0
1008,59,43,16,46,162,161,103,102,104,265,263,16686,2210895.0,16422,17423.75
1009,104,100,11,17,124,123,178,177,120,302,300,22072,3332872.0,21771,22650.0
1010,51,46,16,23,185,184,124,123,139,309,307,22940,3544230.0,22632,23715.75
1011,54,48,19,27,209,208,238,237,486,447,445,49742,11117337.0,49296,49728.75
1012,59,52,19,30,105,104,176,175,95,281,279,18480,2596440.0,18200,19599.75
1013,152,125,48,100,292,291,456,455,2229,748,746,133152,49798848.0,132405,139502.0
1014,148,119,49,105,391,390,528,527,2497,919,917,206448,94862856.0,205530,210680.75
1015,49,44,15,23,84,83,168,167,110,252,250,14112,1778112.0,13861,15750.0
1016,35,33,10,12,104,103,126,125,70,230,228,13104,1506960.0,12875,13110.0
1017,81,60,16,55,305,304,191,190,561,496,494,58255,14447240.0,57760,61256.0
1018,81,73,24,38,222,221,180,179,347,402,400,39960,8031960.0,39559,40200.0
1019,44,39,18,24,236,235,230,229,368,466,464,54280,12647240.0,53815,54056.0
102,101,69,31,91,291,290,310,309,925,601,599,90210,27108105.0,89610,89999.75
1020,46,38,12,23,148,147,106,105,75,254,252,15688,1992376.0,15435,16002.0
1021,47,32,16,44,228,227,208,207,553,436,434,47424,10338432.0,46989,47306.0
1022,72,56,20,50,188,187,172,171,195,360,358,32336,5820480.0,31977,32220.0
1023,170,143,57,108,375,374,512,511,3758,887,885,192000,85152000.0,191114,196248.75
1025,48,45,15,19,123,122,171,170,115,294,292,21033,3091851.0,20740,21462.0
1026,85,71,26,52,213,212,294,293,508,507,505,62622,15874677.0,62116,64008.75
1027,61,44,11,39,105,104,151,150,170,256,254,15855,2029440.0,15600,16256.0
1028,39,33,12,20,157,156,151,150,189,308,306,23707,3650878.0,23400,23562.0
1029,52,45,19,31,198,197,145,144,203,343,341,28710,4923765.0,28368,29240.75
103,55,42,17,38,119,118,125,124,80,244,242,14875,1814750.0,14632,14762.0
1030,59,47,18,39,185,184,122,121,114,307,305,22570,3464495.0,22264,23408.75
1031,48,44,13,17,135,134,136,135,94,271,269,18360,2487780.0,18090,18224.75
1032,51,48,15,19,107,106,86,85,39,193,191,9202,887993.0,9010,9215.75
1033,52,47,17,24,180,179,183,182,186,363,361,32940,5978610.0,32578,32760.75
1034,68,63,17,23,122,121,127,126,87,249,247,15494,1929003.0,15246,15375.75
1035,92,86,24,34,168,167,228,227,319,396,394,38304,7584192.0,37909,39006.0
1036,31,28,9,13,242,241,62,61,113,304,302,15004,2280608.0,14701,22952.0
1037,87,57,24,79,189,188,193,192,362,382,380,36477,6967107.0,36096,36290.0
1038,53,26,11,62,221,220,210,209,465,431,429,46410,10001355.0,45980,46224.75
1039,113,91,45,84,363,362,214,213,573,577,575,77682,22411257.0,77106,82943.75
104,65,60,13,21,111,110,164,163,97,275,273,18204,2503050.0,17930,18768.75
1040,52,47,11,19,95,94,79,78,45,174,172,7505,652935.0,7332,7482.0
1041,62,56,11,21,209,208,133,132,170,342,340,27797,4753287.0,27456,29070.0
1042,171,170,7,7,178,177,178,177,168,356,354,31684,5639752.0,31329,31506.0
1043,63,48,15,33,221,220,124,123,171,345,343,27404,4727190.0,27060,29583.75
1044,39,29,12,26,136,135,122,121,101,258,256,16592,2140368.0,16335,16512.0
1045,59,51,11,24,130,129,85,84,48,215,213,11050,1187875.0,10836,11448.75
1046,67,55,25,45,141,140,186,185,182,327,325,26226,4287951.0,25900,26568.75
1047,64,53,17,35,256,255,129,128,174,385,383,33024,6357120.0,32640,36863.75
1048,33,21,8,29,153,152,148,147,147,301,299,22644,3407922.0,22344,22499.75
1049,60,56,13,18,125,124,164,163,98,289,287,20500,2962250.0,20212,20735.75
105,75,67,19,31,177,176,104,103,119,281,279,18408,2586324.0,18128,19599.75
1050,61,52,18,34,114,113,127,126,77,241,239,14478,1744599.0,14238,14399.75
1051,63,53,20,36,102,101,186,185,105,288,286,18972,2731968.0,18685,20592.0
1052,54,51,17,21,135,134,166,165,165,301,299,22410,3372705.0,22110,22499.75
1053,57,46,16,33,96,95,118,117,57,214,212,11328,1212096.0,11115,11342.0
1054,77,63,24,45,142,141,234,233,230,376,374,33228,6246864.0,32853,35156.0
1055,76,66,16,34,124,123,110,109,67,234,232,13640,1595880.0,13407,13572.0
1056,29,23,11,18,93,92,91,90,36,184,182,8463,778596.0,8280,8372.0
1057,70,56,17,41,129,128,170,169,159,299,297,21930,3278535.0,21632,22200.75
1058,34,25,10,24,183,182,149,148,187,332,330,27267,4526322.0,26936,27390.0
106,55,43,15,32,142,141,183,182,171,325,323,25986,4222725.0,25662,26243.75
1060,99,87,22,42,250,249,178,177,321,428,426,44500,9523000.0,44073,45582.0
1061,61,49,15,35,233,232,176,175,325,409,407,41008,8386136.0,40600,41615.75
1062,62,50,21,41,174,173,111,110,109,285,283,19314,2752245.0,19030,20163.75
1063,65,60,13,21,86,85,149,148,76,235,233,12814,1505645.0,12580,13688.75
1064,40,35,13,21,134,133,98,97,94,232,230,13132,1523312.0,12901,13340.0
1065,94,84,25,43,170,169,194,193,267,364,362,32980,6002360.0,32617,32942.0
1066,61,49,15,36,136,135,107,106,67,243,241,14552,1768068.0,14310,14640.75
1067,43,35,15,29,117,116,218,217,192,335,333,25506,4272255.0,25172,27888.75
1068,106,88,28,62,250,249,275,274,641,525,523,68750,18046875.0,68226,68643.75
1069,161,133,51,103,347,346,437,436,2352,784,782,151639,59442488.0,150856,153272.0
107,79,64,27,55,167,166,216,215,203,383,381,36072,6907788.0,35690,36480.75
1070,41,30,13,31,113,112,100,99,63,213,211,11300,1203450.0,11088,11235.75
1072,61,53,14,27,216,215,324,323,490,540,538,69984,18895680.0,69445,72630.0
1073,39,36,13,16,156,155,258,257,311,414,412,40248,8331336.0,39835,42642.0
1074,54,50,14,20,184,183,91,90,107,275,273,16744,2302300.0,16470,18768.75
1075,60,57,16,20,111,110,161,160,119,272,270,17871,2430456.0,17600,18360.0
1076,47,40,19,31,131,130,236,235,210,367,365,30916,5673086.0,30550,33488.75
1077,28,24,11,15,123,122,132,131,93,255,253,16236,2070090.0,15982,16128.75
1078,22,20,7,8,102,101,177,176,100,279,277,18054,2518533.0,17776,19320.75
1079,138,109,40,95,480,479,449,448,5817,929,927,215520,100109040.0,214592,215295.75
108,104,85,30,66,256,255,172,171,326,428,426,44032,9422848.0,43605,45582.0
1080,55,42,22,43,182,181,238,237,310,420,418,43316,9096360.0,42897,43890.0
1081,55,45,14,32,177,176,254,253,307,431,429,44958,9688449.0,44528,46224.75
1082,105,94,27,47,306,305,384,383,912,690,688,117504,40538880.0,116815,118680.0
1083,63,57,20,28,162,161,129,128,150,291,289,20898,3040659.0,20608,21024.75
1084,50,39,17,37,88,87,126,125,53,214,212,11088,1186416.0,10875,11342.0
1085,137,115,32,73,466,465,267,266,1349,733,731,124422,45600663.0,123690,133955.75
1086,70,56,24,49,178,177,129,128,133,307,305,22962,3524667.0,22656,23408.75
1087,71,58,18,41,146,145,163,162,113,309,307,23798,3676791.0,23490,23715.75
1088,57,48,18,34,201,200,131,130,154,332,330,26331,4370946.0,26000,27390.0
1089,81,64,23,55,356,355,377,376,1815,733,731,134212,49188698.0,133480,133955.75
109,49,35,19,45,125,124,150,149,97,275,273,18750,2578125.0,18476,18768.75
1090,79,70,23,38,172,171,153,152,148,325,323,26316,4276350.0,25992,26243.75
1091,59,55,17,22,256,255,121,120,171,377,375,30976,5838976.0,30600,35343.75
1092,98,90,28,41,239,238,183,182,361,422,420,43737,9228507.0,43316,44310.0
1093,89,77,27,49,319,318,203,202,621,522,520,64757,16901577.0,64236,67860.0
1094,40,36,14,20,145,144,263,262,229,408,406,38135,7779540.0,37728,41412.0
1095,41,37,10,16,100,99,161,160,90,261,259,16100,2101050.0,15840,16899.75
1096,53,38,16,42,168,167,123,122,127,291,289,20664,3006612.0,20374,21024.75
1097,82,65,31,63,207,206,328,327,697,535,533,67896,18162180.0,67362,71288.75
1098,57,51,15,24,104,103,145,144,80,249,247,15080,1877460.0,14832,15375.75
1099,69,63,26,36,138,137,282,281,253,420,418,38916,8172360.0,38497,43890.0
11,45,39,11,21,143,142,221,220,212,364,362,31603,5751746.0,31240,32942.0
110,119,103,27,56,367,366,237,236,871,604,602,86979,26267658.0,86376,90902.0
1100,59,49,16,34,222,221,145,144,207,367,365,32190,5906865.0,31824,33488.75
1101,37,30,13,23,216,215,239,238,504,455,453,51624,11744460.0,51170,51528.75
1102,75,67,18,32,122,121,167,166,107,289,287,20374,2944043.0,20086,20735.75
1103,102,87,37,63,213,212,323,322,707,536,534,68799,18438132.0,68264,71556.0
1104,98,86,37,58,321,320,198,197,591,519,517,63558,16493301.0,63040,67080.75
1105,65,58,20,31,162,161,223,222,271,385,383,36126,6954255.0,35742,36863.75
1107,75,59,23,53,156,155,198,197,297,354,352,30888,5467176.0,30535,31152.0
1108,38,31,9,17,136,135,125,124,96,261,259,17000,2218500.0,16740,16899.75
1109,86,69,21,53,252,251,152,151,234,404,402,38304,7737408.0,37901,40602.0
111,39,31,11,23,137,136,166,165,148,303,301,22742,3445413.0,22440,22800.75
1110,65,57,20,34,113,112,213,212,144,326,324,24069,3923247.0,23744,26406.0
1111,59,49,19,35,112,111,97,96,55,209,207,10864,1135288.0,10656,10815.75
1112,67,56,23,43,300,299,219,218,412,519,517,65700,17049150.0,65182,67080.75
1113,105,82,29,72,246,245,290,289,592,536,534,71340,19119120.0,70805,71556.0
1114,402,394,19,33,504,503,439,438,6095,943,941,221256,104322204.0,220314,221840.75
1115,50,48,11,12,121,120,82,81,78,203,201,9922,1007083.0,9720,10200.75
1116,32,30,10,12,153,152,119,118,97,272,270,18207,2476152.0,17936,18360.0
1117,96,79,36,67,478,477,390,389,2222,868,866,186420,80906280.0,185553,187922.0
1118,64,51,19,43,119,118,144,143,92,263,261,17136,2253384.0,16874,17160.75
1119,41,33,16,29,203,202,201,200,221,404,402,40803,8242206.0,40400,40602.0
112,66,50,24,53,202,201,238,237,444,440,438,48076,10576720.0,47637,48180.0
1120,58,50,19,32,194,193,250,249,334,444,442,48500,10767000.0,48057,49062.0
1121,42,38,12,16,126,125,113,112,72,239,237,14238,1701441.0,14000,14160.75
1123,45,37,10,21,130,129,163,162,126,293,291,21190,3104335.0,20898,21315.75
1124,73,52,16,55,166,165,150,149,205,316,314,24900,3934200.0,24585,24806.0
1125,97,79,33,67,301,300,312,311,721,613,611,93912,28784028.0,93300,93635.75
1126,139,138,8,8,147,146,193,192,190,340,338,28371,4823070.0,28032,28730.0
1127,45,38,14,25,174,173,152,151,146,326,324,26448,4311024.0,26123,26406.0
1128,70,57,19,41,161,160,148,147,159,309,307,23828,3681426.0,23520,23715.75
1129,51,44,11,23,102,101,97,96,45,199,197,9894,984453.0,9696,9800.75
113,43,30,13,37,102,101,144,143,82,246,244,14688,1806624.0,14443,15006.0
1130,38,29,9,24,183,182,276,275,405,459,457,50508,11591586.0,50050,52440.75
1131,88,75,29,53,219,218,257,256,426,476,474,56283,13395354.0,55808,56406.0
1132,74,64,17,35,139,138,174,173,149,313,311,24186,3785109.0,23874,24335.75
1133,102,75,28,80,278,277,263,262,1139,541,539,73114,19777337.0,72574,72899.75
1134,33,30,12,16,128,127,196,195,145,324,322,25088,4064256.0,24765,26082.0
1135,92,79,27,50,158,157,180,179,195,338,336,28440,4806360.0,28103,28392.0
1136,42,37,16,24,168,167,106,105,107,274,272,17808,2439696.0,17535,18632.0
1137,61,54,22,31,228,227,195,194,295,423,421,44460,9403290.0,44038,44520.75
1138,82,66,25,54,360,359,330,329,1055,690,688,118800,40986000.0,118111,118680.0
114,62,48,17,43,128,127,128,127,104,256,254,16384,2097152.0,16129,16256.0
1140,76,53,23,67,183,182,222,221,331,405,403,40626,8226765.0,40222,40803.75
1141,56,40,13,39,125,124,118,117,102,243,241,14750,1792125.0,14508,14640.75
1142,58,53,18,23,222,221,184,183,309,406,404,40848,8292144.0,40443,41006.0
1143,33,29,10,14,105,104,127,126,91,232,230,13335,1546860.0,13104,13340.0
1144,49,42,18,30,115,114,152,151,99,267,265,17480,2333580.0,17214,17688.75
1145,29,26,10,13,190,189,158,157,182,348,346,30020,5223480.0,29673,30102.0
1146,77,50,28,79,187,186,179,178,224,366,364,33473,6125559.0,33108,33306.0
1147,59,57,16,18,89,88,141,140,65,230,228,12549,1443135.0,12320,13110.0
1148,52,43,15,30,137,136,143,142,114,280,278,19591,2742740.0,19312,19460.0
1149,58,52,17,27,171,170,153,152,174,324,322,26163,4238406.0,25840,26082.0
115,79,67,25,45,299,298,199,198,359,498,496,59501,14815749.0,59004,61752.0
1150,62,46,11,32,109,108,97,96,52,206,204,10573,1089019.0,10368,10506.0
1151,73,70,19,23,135,134,119,118,103,254,252,16065,2040255.0,15812,16002.0
1152,56,49,12,21,106,105,105,104,46,211,209,11130,1174215.0,10920,11024.75
1153,98,97,4,4,124,123,170,169,109,294,292,21080,3098760.0,20787,21462.0
1154,43,38,9,17,99,98,137,136,57,236,234,13563,1600434.0,13328,13806.0
1155,93,76,23,55,187,186,254,253,390,441,439,47498,10473309.0,47058,48399.75
1156,68,61,21,33,124,123,166,165,131,290,288,20584,2984680.0,20295,20880.0
1157,42,37,13,19,186,185,128,127,185,314,312,23808,3737856.0,23495,24492.0
1158,29,23,7,14,182,181,258,257,385,440,438,46956,10330320.0,46517,48180.0
1159,69,55,21,46,191,190,228,227,454,419,417,43548,9123306.0,43130,43680.75
116,86,65,22,61,272,271,202,201,500,474,472,54944,13021728.0,54471,55932.0
1160,64,56,14,28,198,197,100,99,125,298,296,19800,2950200.0,19503,22052.0
1161,62,57,20,26,315,314,140,139,263,455,453,44100,10032750.0,43646,51528.75
1162,57,50,21,31,181,180,287,286,319,468,466,51947,12155598.0,51480,54522.0
1163,115,95,30,68,215,214,184,183,354,399,397,39560,7892220.0,39162,39600.75
1164,34,23,9,24,110,109,199,198,140,309,307,21890,3382005.0,21582,23715.75
1165,51,44,17,26,121,120,111,110,68,232,230,13431,1557996.0,13200,13340.0
1166,56,54,11,13,196,195,124,123,121,320,318,24304,3888640.0,23985,25440.0
1167,68,58,24,35,148,147,183,182,180,331,329,27084,4482402.0,26754,27224.75
1168,105,94,28,48,161,160,257,256,237,418,416,41377,8647793.0,40960,43472.0
1169,23,21,5,6,131,130,119,118,71,250,248,15589,1948625.0,15340,15500.0
117,59,41,19,50,268,267,207,206,410,475,473,55476,13175550.0,55002,56168.75
1170,47,36,14,34,158,157,201,200,196,359,357,31758,5700561.0,31400,32040.75
1171,73,60,16,38,148,147,123,122,116,271,269,18204,2466642.0,17934,18224.75
1172,35,28,9,21,267,266,109,108,184,376,374,29103,5471364.0,28728,35156.0
1173,47,40,9,21,157,156,133,132,103,290,288,20881,3027745.0,20592,20880.0
1174,105,90,33,56,207,206,257,256,613,464,462,53199,12342168.0,52736,53592.0
1175,62,50,15,37,152,151,109,108,73,261,259,16568,2162124.0,16308,16899.75
1176,66,56,22,39,125,124,163,162,120,288,286,20375,2934000.0,20088,20592.0
1177,49,32,11,43,324,323,212,211,670,536,534,68688,18408384.0,68153,71556.0
1178,169,136,61,124,535,534,280,279,1450,815,813,149800,61043500.0,148986,165648.75
1179,108,84,38,84,324,323,259,258,877,583,581,83916,24461514.0,83334,84680.75
118,192,133,55,169,335,334,500,499,4687,835,833,167500,69931250.0,166666,173888.75
1180,20,17,7,9,146,145,176,175,204,322,320,25696,4137056.0,25375,25760.0
1181,51,47,11,15,128,127,108,107,65,236,234,13824,1631232.0,13589,13806.0
1182,83,74,27,43,436,435,293,292,1021,729,727,127748,46564146.0,127020,132495.75
1183,43,30,15,38,128,127,126,125,84,254,252,16128,2048256.0,15875,16002.0
1184,91,81,19,37,155,154,142,141,131,297,295,22010,3268485.0,21714,21903.75
1185,34,29,9,15,103,102,160,159,98,263,261,16480,2167120.0,16218,17160.75
1186,40,34,8,15,104,103,127,126,55,231,229,13208,1525524.0,12978,13224.75
1187,140,139,7,7,147,146,147,146,130,294,292,21609,3176523.0,21316,21462.0
1188,74,66,23,35,206,205,219,218,316,425,423,45114,9586725.0,44690,44943.75
119,257,256,10,10,267,266,267,266,594,534,532,71289,19034163.0,70756,71022.0
1190,29,26,11,14,146,145,101,100,74,247,245,14746,1821131.0,14500,15128.75
1191,131,110,44,82,353,352,544,543,2509,897,895,192032,86126352.0,191136,200703.75
1192,77,66,21,41,129,128,184,183,157,313,311,23736,3714684.0,23424,24335.75
1193,36,32,13,18,120,119,171,170,128,291,289,20520,2985660.0,20230,21024.75
1194,76,69,17,28,222,221,124,123,185,346,344,27528,4762344.0,27183,29756.0
1195,52,43,17,28,113,112,143,142,90,256,254,16159,2068352.0,15904,16256.0
1196,57,47,14,30,169,168,129,128,112,298,296,21801,3248349.0,21504,22052.0
1197,31,24,8,20,193,192,252,251,362,445,443,48636,10821510.0,48192,49283.75
1198,69,60,25,40,225,224,155,154,267,380,378,34875,6626250.0,34496,35910.0
1199,45,39,16,26,202,201,239,238,356,441,439,48278,10645299.0,47838,48399.75
12,50,39,13,29,229,228,94,93,159,323,321,21526,3476449.0,21204,25920.75
120,66,54,17,37,174,173,131,130,162,305,303,22794,3476085.0,22490,23103.75
1200,68,53,25,52,274,273,255,254,729,529,527,69870,18480615.0,69342,69695.75
1201,38,32,5,15,79,78,113,112,71,192,190,8927,856992.0,8736,9120.0
1202,38,31,14,22,76,75,163,162,67,239,237,12388,1480366.0,12150,14160.75
1204,143,127,30,60,233,232,409,408,705,642,640,95297,30590337.0,94656,102720.0
1206,96,77,38,71,269,268,281,280,563,550,548,75589,20786975.0,75040,75350.0
1207,50,39,17,37,265,264,435,434,1347,700,698,115275,40346250.0,114576,122150.0
1208,61,48,18,40,216,215,159,158,271,375,373,34344,6439500.0,33970,34968.75
1209,69,62,18,29,130,129,113,112,73,243,241,14690,1784835.0,14448,14640.75
121,21,18,8,11,119,118,177,176,118,296,294,21063,3117324.0,20768,21756.0
1210,98,86,20,42,286,285,184,183,557,470,468,52624,12366640.0,52155,54990.0
1211,172,142,57,115,336,335,388,387,1688,724,722,130368,47193216.0,129645,130682.0
1212,49,40,18,32,165,164,89,88,81,254,252,14685,1864995.0,14432,16002.0
1213,85,67,24,58,202,201,231,230,408,433,431,46662,10102323.0,46230,46655.75
1214,151,122,50,105,381,380,386,385,1594,767,765,147066,56399811.0,146300,146688.75
1215,94,84,24,41,253,252,139,138,231,392,390,35167,6892732.0,34776,38220.0
1216,64,53,21,41,190,189,137,136,171,327,325,26030,4255905.0,25704,26568.75
1217,45,34,15,35,175,174,271,270,414,446,444,47425,10575775.0,46980,49506.0
1218,32,31,8,8,292,291,129,128,341,421,419,37668,7929114.0,37248,44099.75
1219,28,24,9,13,146,145,138,137,115,284,282,20148,2861016.0,19865,20022.0
122,184,153,54,114,463,462,489,488,2815,952,950,226407,107769732.0,225456,226100.0
1220,105,95,20,37,283,282,239,238,794,522,520,67637,17653257.0,67116,67860.0
1221,34,26,8,18,136,135,90,89,70,226,224,12240,1383120.0,12015,12656.0
1222,127,111,39,69,337,336,308,307,1116,645,643,103796,33474210.0,103152,103683.75
1223,37,33,9,14,117,116,159,158,100,276,274,18603,2567214.0,18328,18906.0
1224,75,66,25,41,244,243,263,262,448,507,505,64172,16267602.0,63666,64008.75
1225,49,40,14,28,140,139,231,230,359,371,369,32340,5999070.0,31970,34224.75
1226,24,20,8,14,99,98,216,215,111,315,313,21384,3367980.0,21070,24648.75
1227,68,63,9,15,122,121,112,111,81,234,232,13664,1598688.0,13431,13572.0
1228,18,17,4,4,126,125,115,114,69,241,239,14490,1746045.0,14250,14399.75
1229,63,56,21,33,132,131,137,136,89,269,267,18084,2432298.0,17816,17955.75
123,52,37,18,44,116,115,143,142,104,259,257,16588,2148146.0,16330,16640.75
1230,88,75,28,51,167,166,259,258,306,426,424,43253,9212889.0,42828,45156.0
1233,37,26,10,29,209,208,127,126,232,336,334,26543,4459224.0,26208,28056.0
1234,108,95,34,58,198,197,254,253,334,452,450,50292,11365992.0,49841,50850.0
1235,34,25,12,26,143,142,101,100,93,244,242,14443,1762046.0,14200,14762.0
1236,41,35,14,24,167,166,188,187,347,355,353,31396,5572790.0,31042,31328.75
1237,66,58,22,36,117,116,170,169,197,287,285,19890,2854215.0,19604,20448.75
1238,42,39,14,18,197,196,120,119,122,317,315,23640,3746940.0,23324,24963.75
1239,69,61,15,28,129,128,222,221,203,351,349,28638,5025969.0,28288,30624.75
124,36,32,13,16,142,141,162,161,130,304,302,23004,3496608.0,22701,22952.0
1240,39,31,17,31,199,198,214,213,290,413,411,42586,8794009.0,42174,42435.75
1241,59,47,14,33,145,144,115,114,119,260,258,16675,2167750.0,16416,16770.0
1242,57,49,13,22,139,138,121,120,83,260,258,16819,2186470.0,16560,16770.0
1243,62,53,16,32,134,133,185,184,123,319,317,24790,3954005.0,24472,25280.75
1244,58,52,14,24,86,85,162,161,63,248,246,13932,1727568.0,13685,15252.0
1245,25,22,10,14,135,134,155,154,105,290,288,20925,3034125.0,20636,20880.0
1246,80,67,25,45,173,172,147,146,169,320,318,25431,4068960.0,25112,25440.0
1247,87,69,32,64,292,291,312,311,840,604,602,91104,27513408.0,90501,90902.0
1248,30,26,10,15,312,311,141,140,423,453,451,43992,9964188.0,43540,51075.75
1249,63,54,21,37,213,212,144,143,215,357,355,30672,5474952.0,30316,31683.75
125,53,48,17,25,294,293,226,225,553,520,518,66444,17275440.0,65925,67340.0
1250,26,24,10,12,129,128,197,196,197,326,324,25413,4142319.0,25088,26406.0
1251,27,17,7,23,153,152,110,109,95,263,261,16830,2213145.0,16568,17160.75
1252,70,55,15,43,156,155,134,133,183,290,288,20904,3031080.0,20615,20880.0
1253,66,56,19,37,163,162,125,124,120,288,286,20375,2934000.0,20088,20592.0
1254,70,58,18,40,149,148,158,157,191,307,305,23542,3613697.0,23236,23408.75
1255,68,56,21,43,194,193,177,176,206,371,369,34338,6369699.0,33968,34224.75
1256,44,31,11,25,130,129,136,135,106,266,264,17680,2351440.0,17415,17556.0
1257,360,352,14,28,377,376,377,376,1989,754,752,142129,53582633.0,141376,141752.0
1258,53,42,20,40,165,164,116,115,77,281,279,19140,2689170.0,18860,19599.75
126,49,39,16,34,140,139,94,93,51,234,232,13160,1539720.0,12927,13572.0
1260,32,29,8,10,185,184,131,130,129,316,314,24235,3829130.0,23920,24806.0
1261,28,20,9,23,100,99,116,115,64,216,214,11600,1252800.0,11385,11556.0
1262,257,256,10,10,267,266,267,266,614,534,532,71289,19034163.0,70756,71022.0
1263,33,17,4,30,100,99,124,123,88,224,222,12400,1388800.0,12177,12432.0
1264,67,52,20,46,291,290,407,406,2169,698,696,118437,41334513.0,117740,121452.0
1265,55,41,13,37,129,128,91,90,71,220,218,11739,1291290.0,11520,11990.0
1266,57,53,15,21,132,131,82,81,45,214,212,10824,1158168.0,10611,11342.0
1267,47,37,13,31,117,116,148,147,78,265,263,17316,2294370.0,17052,17423.75
1268,51,42,14,30,110,109,140,139,101,250,248,15400,1925000.0,15151,15500.0
1269,93,77,29,57,157,156,176,175,198,333,331,27632,4600728.0,27300,27555.75
127,53,47,10,20,104,103,90,89,47,194,192,9360,907920.0,9167,9312.0
1270,56,49,21,33,179,178,344,343,503,523,521,61576,16102124.0,61054,68120.75
1271,97,84,25,49,240,239,199,198,314,439,437,47760,10483320.0,47322,47960.75
1272,39,33,13,21,156,155,133,132,122,289,287,20748,2998086.0,20460,20735.75
1273,130,114,41,70,227,226,367,366,613,594,592,83309,24742773.0,82716,87912.0
1274,76,57,27,63,304,303,237,236,608,541,539,72048,19488984.0,71508,72899.75
1275,60,47,18,42,227,226,170,169,262,397,395,38590,7660115.0,38194,39203.75
1276,24,22,5,7,112,111,63,62,35,175,173,7056,617400.0,6882,7568.75
1277,64,56,19,30,215,214,165,164,330,380,378,35475,6740250.0,35096,35910.0
1278,33,27,10,17,272,271,217,216,323,489,487,59024,14431368.0,58536,59535.75
128,41,35,13,21,175,174,264,263,360,439,437,46200,10140900.0,45762,47960.75
1280,31,28,10,12,102,101,166,165,94,268,266,16932,2268888.0,16665,17822.0
1281,49,39,18,36,139,138,138,137,159,277,275,19182,2656707.0,18906,19043.75
1282,32,30,12,14,184,183,101,100,111,285,283,18584,2648220.0,18300,20163.75
1283,78,68,26,44,177,176,249,248,389,426,424,44073,9387549.0,43648,45156.0
1284,78,60,26,60,201,200,349,348,662,550,548,70149,19290975.0,69600,75350.0
1285,97,78,31,62,358,357,350,349,1601,708,706,125300,44356200.0,124593,124962.0
1286,87,70,26,57,195,194,194,193,269,389,387,37830,7357935.0,37442,37635.75
1287,52,44,20,31,167,166,176,175,149,343,341,29392,5040728.0,29050,29240.75
1288,83,71,32,54,264,263,312,311,735,576,574,82368,23721984.0,81793,82656.0
1289,62,55,17,28,171,170,273,272,290,444,442,46683,10363626.0,46240,49062.0
129,40,35,11,19,124,123,183,182,164,307,305,22692,3483222.0,22386,23408.75
1290,148,131,54,84,362,361,437,436,1912,799,797,158194,63198503.0,157396,159200.75
1291,81,63,19,41,204,203,277,276,662,481,479,56508,13590174.0,56028,57599.75
1292,115,106,23,39,150,149,221,220,213,371,369,33150,6149325.0,32780,34224.75
1293,136,113,48,87,288,287,441,440,1231,729,727,127008,46294416.0,126280,132495.75
1294,80,63,22,50,174,173,180,179,264,354,352,31320,5543640.0,30967,31152.0
1295,23,21,7,8,261,260,128,127,243,389,387,33408,6497856.0,33020,37635.75
1296,115,93,33,75,314,313,239,238,599,553,551,75046,20750219.0,74494,76175.75
1297,50,41,12,27,260,259,170,169,363,430,428,44200,9503000.0,43771,46010.0
1298,64,59,21,29,133,132,150,149,107,283,281,19950,2822925.0,19668,19880.75
1299,33,28,12,18,242,241,199,198,314,441,439,48158,10618839.0,47718,48399.75
13,42,34,14,26,141,140,141,140,97,282,280,19881,2803221.0,19600,19740.0
130,43,40,11,15,143,142,136,135,147,279,277,19448,2712996.0,19170,19320.75
1300,107,83,29,75,209,208,228,227,425,437,435,47652,10411962.0,47216,47523.75
1301,95,83,27,49,229,228,364,363,943,593,591,83356,24715054.0,82764,87615.75
1302,65,47,20,54,160,159,155,154,165,315,313,24800,3906000.0,24486,24648.75
1303,75,56,23,59,242,241,173,172,348,415,413,41866,8687195.0,41452,42848.75
1304,56,48,18,32,128,127,136,135,97,264,262,17408,2297856.0,17145,17292.0
1305,35,30,12,20,143,142,160,159,155,303,301,22880,3466320.0,22578,22800.75
1306,28,27,7,7,92,91,108,107,47,200,198,9936,993600.0,9737,9900.0
1307,47,41,13,21,143,142,173,172,166,316,314,24739,3908762.0,24424,24806.0
1308,47,37,14,30,161,160,250,249,370,411,409,40250,8271375.0,39840,42024.75
1309,135,109,45,95,415,414,291,290,1272,706,704,120765,42630045.0,120060,124256.0
131,83,71,16,38,197,196,253,252,599,450,448,49841,11214225.0,49392,50400.0
1310,95,82,33,57,214,213,350,349,976,564,562,74900,21121800.0,74337,79242.0
1311,31,25,13,22,179,178,264,263,366,443,441,47256,10467204.0,46814,48840.75
1312,37,30,10,19,298,297,179,178,390,477,475,53342,12722067.0,52866,56643.75
1314,72,58,25,50,402,401,513,512,3290,915,913,206226,94348395.0,205312,208848.75
1315,37,35,10,12,115,114,183,182,129,298,296,21045,3135705.0,20748,22052.0
1316,26,24,8,10,83,82,109,108,41,192,190,9047,868512.0,8856,9120.0
1317,48,42,13,23,121,120,104,103,66,225,223,12584,1415700.0,12360,12543.75
1318,39,28,10,29,85,84,146,145,63,231,229,12410,1433355.0,12180,13224.75
1319,49,41,16,30,86,85,234,233,108,320,318,20124,3219840.0,19805,25440.0
132,72,59,22,46,145,144,176,175,190,321,319,25520,4095960.0,25200,25599.75
1320,73,65,19,33,138,137,151,150,128,289,287,20838,3011091.0,20550,20735.75
1321,79,66,23,45,209,208,183,182,372,392,390,38247,7496412.0,37856,38220.0
1322,26,21,9,15,125,124,117,116,75,242,240,14625,1769625.0,14384,14520.0
1323,30,24,14,23,195,194,273,272,342,468,466,53235,12456990.0,52768,54522.0
1324,28,26,8,10,101,100,184,183,103,285,283,18584,2648220.0,18300,20163.75
1325,113,89,29,74,294,293,267,266,717,561,559,78498,22018689.0,77938,78399.75
1326,69,63,23,32,230,229,140,139,268,370,368,32200,5957000.0,31831,34040.0
1327,90,71,30,61,167,166,220,219,377,387,385,36740,7109190.0,36354,37248.75
1328,48,42,12,21,183,182,148,147,192,331,329,27084,4482402.0,26754,27224.75
1329,118,96,44,86,269,268,377,376,725,646,644,101413,32756399.0,100768,104006.0
133,83,69,33,55,230,229,402,401,892,632,630,92460,29217360.0,91829,99540.0
1330,53,49,16,22,157,156,182,181,148,339,337,28574,4843293.0,28236,28560.75
1331,101,87,38,55,371,370,276,275,1123,647,645,102396,33125106.0,101750,104328.75
1332,108,101,25,36,176,175,197,196,246,373,371,34672,6466328.0,34300,34595.75
1333,56,48,21,35,203,202,168,167,213,371,369,34104,6326292.0,33734,34224.75
1334,127,98,41,95,319,318,337,336,1162,656,654,107503,35260984.0,106848,107256.0
1335,118,99,34,67,284,283,273,272,738,557,555,77532,21592662.0,76976,77283.75
1336,56,44,17,38,192,191,128,127,200,320,318,24576,3932160.0,24257,25440.0
1337,48,42,14,24,194,193,130,129,136,324,322,25220,4085640.0,24897,26082.0
1338,116,98,34,68,227,226,314,313,522,541,539,71278,19280699.0,70738,72899.75
1339,139,138,9,9,170,169,147,146,153,317,315,24990,3960915.0,24674,24963.75
134,45,40,12,19,179,178,78,77,77,257,255,13962,1794117.0,13706,16383.75
1340,35,28,12,23,220,219,155,154,203,375,373,34100,6393750.0,33726,34968.75
1341,62,52,19,37,125,124,123,122,61,248,246,15375,1906500.0,15128,15252.0
1342,43,32,17,37,137,136,140,139,126,277,275,19180,2656430.0,18904,19043.75
1343,96,85,28,45,228,227,178,177,225,406,404,40584,8238552.0,40179,41006.0
1344,83,67,23,51,203,202,186,185,340,389,387,37758,7343931.0,37370,37635.75
1345,51,43,16,25,221,220,332,331,744,553,551,73372,20287358.0,72820,76175.75
1346,55,48,12,23,234,233,167,166,329,401,399,39078,7835139.0,38678,39999.75
1347,67,57,24,42,231,230,160,159,221,391,389,36960,7225680.0,36570,38024.75
1348,47,37,15,32,94,93,153,152,127,247,245,14382,1776177.0,14136,15128.75
1349,57,36,19,58,170,169,140,139,155,310,308,23800,3689000.0,23491,23870.0
135,151,126,57,103,442,441,502,501,5382,944,942,221884,104729248.0,220941,222312.0
1350,42,37,13,19,284,283,238,237,649,522,520,67592,17641512.0,67071,67860.0
1351,103,80,28,72,169,168,206,205,250,375,373,34814,6527625.0,34440,34968.75
1352,45,33,12,33,143,142,88,87,78,231,229,12584,1453452.0,12354,13224.75
1353,34,31,14,16,102,101,220,219,138,322,320,22440,3612840.0,22119,25760.0
1354,77,64,20,44,188,187,243,242,332,431,429,45684,9844902.0,45254,46224.75
1355,42,35,14,24,122,121,229,228,162,351,349,27938,4903119.0,27588,30624.75
1356,60,58,13,15,162,161,112,111,104,274,272,18144,2485728.0,17871,18632.0
1357,64,53,15,35,354,353,144,143,468,498,496,50976,12693024.0,50479,61752.0
1358,62,52,28,46,350,349,308,307,1488,658,656,107800,35466200.0,107143,107912.0
1359,89,68,19,57,177,176,202,201,316,379,377,35754,6775383.0,35376,35720.75
136,36,29,11,22,115,114,145,144,86,260,258,16675,2167750.0,16416,16770.0
1361,40,36,14,18,174,173,142,141,148,316,314,24708,3903864.0,24393,24806.0
1363,101,80,39,79,214,213,290,289,569,504,502,62060,15639120.0,61557,63252.0
1364,27,16,6,18,105,104,79,78,45,184,182,8295,763140.0,8112,8372.0
1365,70,62,11,23,155,154,177,176,242,332,330,27435,4554210.0,27104,27390.0
1366,68,57,22,42,214,213,172,171,293,386,384,36808,7103944.0,36423,37056.0
1367,54,47,13,23,90,89,113,112,73,203,201,10170,1032255.0,9968,10200.75
1368,50,46,15,21,179,178,88,87,87,267,265,15752,2102892.0,15486,17688.75
1369,65,53,20,40,227,226,381,380,1063,608,606,86487,26292048.0,85880,92112.0
137,49,45,12,16,99,98,140,139,62,239,237,13860,1656270.0,13622,14160.75
1370,65,57,19,33,140,139,103,102,106,243,241,14420,1752030.0,14178,14640.75
1371,50,42,11,25,119,118,72,71,41,191,189,8568,818244.0,8378,9024.75
1372,64,42,15,57,189,188,139,138,256,328,326,26271,4308444.0,25944,26732.0
1373,55,45,19,36,248,247,241,240,350,489,487,59768,14613276.0,59280,59535.75
1374,47,42,13,21,87,86,94,93,46,181,179,8178,740109.0,7998,8099.75
1376,40,37,11,15,76,75,160,159,63,236,234,12160,1434880.0,11925,13806.0
1377,36,30,10,19,175,174,102,101,85,277,275,17850,2472225.0,17574,19043.75
1378,70,56,20,43,169,168,110,109,134,279,277,18590,2593305.0,18312,19320.75
138,51,43,15,29,135,134,88,87,61,223,221,11880,1324620.0,11658,12320.75
1380,54,46,12,23,141,140,150,149,102,291,289,21150,3077325.0,20860,21024.75
1381,110,97,43,65,241,240,254,253,520,495,493,61214,15150465.0,60720,61008.75
1382,77,60,22,53,172,171,245,244,375,417,415,42140,8786190.0,41724,43263.75
1383,68,57,19,39,112,111,104,103,57,216,214,11648,1257984.0,11433,11556.0
1384,51,40,17,37,150,149,115,114,113,265,263,17250,2285625.0,16986,17423.75
1385,59,49,16,27,130,129,185,184,163,315,313,24050,3787875.0,23736,24648.75
1386,25,22,5,9,134,133,161,160,124,295,293,21574,3182165.0,21280,21608.75
1387,29,22,10,22,212,211,270,269,500,482,480,57240,13794840.0,56759,57840.0
1388,79,64,24,51,170,169,165,164,214,335,333,28050,4698375.0,27716,27888.75
1389,64,56,26,40,147,146,158,157,116,305,303,23226,3541965.0,22922,23103.75
139,99,79,23,61,215,214,429,428,972,644,642,92235,29699670.0,91592,103362.0
1390,29,25,9,14,161,160,201,200,254,362,360,32361,5857341.0,32000,32580.0
1391,51,45,16,26,505,504,385,384,2592,890,888,194425,86519125.0,193536,197580.0
1392,79,66,22,46,156,155,151,150,161,307,305,23556,3615846.0,23250,23408.75
1393,82,70,27,49,202,201,209,208,343,411,409,42218,8675799.0,41808,42024.75
1394,91,77,26,52,267,266,175,174,406,442,440,46725,10326225.0,46284,48620.0
1395,64,53,21,39,153,152,117,116,75,270,268,17901,2416635.0,17632,18090.0
1396,85,74,28,47,214,213,389,388,1130,603,601,83246,25098669.0,82644,90600.75
1397,48,35,14,38,251,250,208,207,463,459,457,52208,11981736.0,51750,52440.75
1398,126,120,13,22,170,169,178,177,213,348,346,30260,5265240.0,29913,30102.0
1399,55,52,14,17,83,82,99,98,32,182,180,8217,747747.0,8036,8190.0
14,30,28,8,10,112,111,180,179,118,292,290,20160,2943360.0,19869,21170.0
140,66,52,22,47,150,149,194,193,211,344,342,29100,5005200.0,28757,29412.0
1400,77,57,20,55,162,161,149,148,174,311,309,24138,3753459.0,23828,24024.75
1401,57,52,22,29,489,488,208,207,911,697,695,101712,35446632.0,101016,121103.75
1402,84,70,22,48,227,226,193,192,357,420,418,43811,9200310.0,43392,43890.0
1403,51,50,9,9,204,203,136,135,174,340,338,27744,4716480.0,27405,28730.0
1404,31,27,13,18,87,86,135,134,47,222,220,11745,1303695.0,11524,12210.0
1405,95,78,31,63,173,172,308,307,550,481,479,53284,12814802.0,52804,57599.75
1406,73,55,21,55,156,155,272,271,316,428,426,42432,9080448.0,42005,45582.0
1407,139,138,9,9,147,146,193,192,177,340,338,28371,4823070.0,28032,28730.0
1408,102,82,25,63,316,315,213,212,635,529,527,67308,17802966.0,66780,69695.75
1409,63,52,22,42,226,225,238,237,363,464,462,53788,12478816.0,53325,53592.0
141,40,36,12,17,249,248,159,158,247,408,406,39591,8076564.0,39184,41412.0
1410,113,97,27,56,267,266,193,192,438,460,458,51531,11852130.0,51072,52670.0
1411,63,51,26,44,169,168,142,141,152,311,309,23998,3731689.0,23688,24024.75
1412,56,50,19,29,215,214,145,144,170,360,358,31175,5611500.0,30816,32220.0
1413,80,74,14,24,133,132,124,123,81,257,255,16492,2119222.0,16236,16383.75
1414,44,41,15,19,282,281,125,124,217,407,405,35250,7173375.0,34844,41208.75
1415,145,122,36,79,444,443,291,290,2368,735,733,129204,47482470.0,128470,134688.75
1416,49,43,20,30,168,167,296,295,334,464,462,49728,11536896.0,49265,53592.0
1417,22,21,8,8,87,86,134,133,50,221,219,11658,1288209.0,11438,12099.75
1418,55,47,21,34,208,207,193,192,267,401,399,40144,8048872.0,39744,39999.75
1419,32,30,7,9,168,167,131,130,104,299,297,22008,3290196.0,21710,22200.75
142,63,55,25,39,166,165,181,180,261,347,345,30046,5212981.0,29700,29928.75
1420,45,39,14,24,177,176,83,82,79,260,258,14691,1909830.0,14432,16770.0
1421,57,49,15,29,217,216,110,109,149,327,325,23870,3902745.0,23544,26568.75
1422,35,31,10,14,136,135,133,132,99,269,267,18088,2432836.0,17820,17955.75
1423,51,43,15,29,169,168,149,148,141,318,316,25181,4003779.0,24864,25122.0
1424,52,47,10,18,112,111,129,128,115,241,239,14448,1740984.0,14208,14399.75
1425,31,28,11,15,82,81,114,113,37,196,194,9348,916104.0,9153,9506.0
1426,54,38,15,44,172,171,144,143,169,316,314,24768,3913344.0,24453,24806.0
1427,67,60,21,33,194,193,267,266,529,461,459,51798,11939439.0,51338,52899.75
1428,46,38,16,28,187,186,109,108,110,296,294,20383,3016684.0,20088,21756.0
1429,51,44,11,18,150,149,86,85,63,236,234,12900,1522200.0,12665,13806.0
143,53,42,10,30,91,90,114,113,61,205,203,10374,1063335.0,10170,10403.75
1430,83,77,17,27,130,129,117,116,96,247,245,15210,1878435.0,14964,15128.75
1431,37,31,9,14,83,82,135,134,58,218,216,11205,1221345.0,10988,11772.0
1432,46,40,19,29,102,101,138,137,70,240,238,14076,1689120.0,13837,14280.0
1433,60,54,15,23,103,102,128,127,52,231,229,13184,1522752.0,12954,13224.75
1434,114,100,37,63,234,233,222,221,644,456,454,51948,11844144.0,51493,51756.0
1435,59,53,13,23,105,104,99,98,47,204,202,10395,1060290.0,10192,10302.0
1436,95,71,32,78,340,339,219,218,704,559,557,74460,20811570.0,73902,77840.75
1437,82,76,23,33,176,175,190,189,226,366,364,33440,6119520.0,33075,33306.0
1438,37,34,8,12,123,122,163,162,87,286,284,20049,2867007.0,19764,20306.0
1439,67,60,18,30,193,192,151,150,151,344,342,29143,5012596.0,28800,29412.0
144,54,48,13,23,144,143,189,188,141,333,331,27216,4531464.0,26884,27555.75
1440,113,108,12,19,178,177,285,284,481,463,461,50730,11743995.0,50268,53360.75
1441,41,37,11,17,130,129,119,118,72,249,247,15470,1926015.0,15222,15375.75
1442,42,38,13,18,144,143,153,152,169,297,295,22032,3271752.0,21736,21903.75
1443,73,64,18,32,138,137,136,135,108,274,272,18768,2571216.0,18495,18632.0
1444,67,51,24,53,340,339,291,290,1006,631,629,98940,31215570.0,98310,99224.75
1445,34,28,11,21,171,170,233,232,242,404,402,39843,8048286.0,39440,40602.0
1446,58,41,14,46,123,122,133,132,91,256,254,16359,2093952.0,16104,16256.0
1447,62,47,18,42,179,178,134,133,146,313,311,23986,3753809.0,23674,24335.75
1448,69,58,30,49,343,342,318,317,999,661,659,109074,36048957.0,108414,108899.75
1449,166,135,48,108,370,369,452,451,2893,822,820,167240,68735640.0,166419,168510.0
145,102,83,35,69,366,365,272,271,1140,638,636,99552,31757088.0,98915,101442.0
1450,93,73,31,67,346,345,249,248,754,595,593,86154,25630815.0,85560,88208.75
1451,49,43,15,25,233,232,118,117,200,351,349,27494,4825197.0,27144,30624.75
1452,94,79,28,49,195,194,171,170,242,366,364,33345,6102135.0,32980,33306.0
1453,137,123,29,53,267,266,261,260,598,528,526,69687,18397368.0,69160,69432.0
1454,52,31,13,53,144,143,143,142,133,287,285,20592,2954952.0,20306,20448.75
1455,68,64,18,24,135,134,135,134,103,270,268,18225,2460375.0,17956,18090.0
1456,68,60,27,41,180,179,178,177,215,358,356,32040,5735160.0,31683,31862.0
1457,44,37,13,25,95,94,151,150,71,246,244,14345,1764435.0,14100,15006.0
1458,96,80,29,58,332,331,467,466,2571,799,797,155044,61940078.0,154246,159200.75
1459,53,45,15,29,170,169,99,98,114,269,267,16830,2263635.0,16562,17955.75
146,63,51,19,37,134,133,154,153,109,288,286,20636,2971584.0,20349,20592.0
1460,46,42,11,17,107,106,143,142,83,250,248,15301,1912625.0,15052,15500.0
1461,151,136,37,65,447,446,535,534,7602,982,980,239145,117420195.0,238164,240590.0
1462,54,44,18,35,202,201,117,116,124,319,317,23634,3769623.0,23316,25280.75
1463,53,46,16,24,184,183,332,331,496,516,514,61088,15760704.0,60573,66306.0
1464,59,48,17,34,170,169,177,176,224,347,345,30090,5220615.0,29744,29928.75
1465,35,27,9,20,155,154,86,85,72,241,239,13330,1606265.0,13090,14399.75
1466,31,27,10,16,239,238,77,76,107,316,314,18403,2907674.0,18088,24806.0
1467,35,34,9,9,141,140,96,95,54,237,235,13536,1604016.0,13300,13923.75
1468,41,36,13,20,84,83,138,137,59,222,220,11592,1286712.0,11371,12210.0
1469,143,117,49,99,409,408,413,412,2272,822,820,168917,69424887.0,168096,168510.0
147,59,52,18,30,114,113,183,182,158,297,295,20862,3098007.0,20566,21903.75
1470,78,58,20,58,133,132,306,305,319,439,437,40698,8933211.0,40260,47960.75
1471,32,26,11,21,137,136,320,319,320,457,455,43840,10017440.0,43384,51983.75
1472,83,71,11,27,139,138,170,169,203,309,307,23630,3650835.0,23322,23715.75
1473,38,28,10,21,116,115,80,79,41,196,194,9280,909440.0,9085,9506.0
1474,34,30,8,13,80,79,93,92,32,173,171,7440,643560.0,7268,7395.75
1475,79,65,26,51,242,241,379,378,928,621,619,91718,28478439.0,91098,96099.75
1476,62,55,19,31,104,103,151,150,82,255,253,15704,2002260.0,15450,16128.75
1477,48,45,14,18,125,124,94,93,74,219,217,11750,1286625.0,11532,11880.75
1478,98,69,25,73,178,177,225,224,443,403,401,40050,8070075.0,39648,40400.75
1479,30,27,8,11,121,120,204,203,126,325,323,24684,4011150.0,24360,26243.75
148,38,34,13,19,125,124,190,189,134,315,313,23750,3740625.0,23436,24648.75
1480,66,54,18,39,111,110,161,160,123,272,270,17871,2430456.0,17600,18360.0
1481,87,76,28,48,204,203,322,321,590,526,524,65688,17275944.0,65163,68906.0
1482,46,42,17,23,94,93,129,128,69,223,221,12126,1352049.0,11904,12320.75
1483,20,18,6,7,80,79,84,83,27,164,162,6720,551040.0,6557,6642.0
1484,45,40,18,26,162,161,143,142,175,305,303,23166,3532815.0,22862,23103.75
1485,69,59,24,38,357,356,271,270,1031,628,626,96747,30378558.0,96120,98282.0
1486,42,35,14,25,132,131,115,114,74,247,245,15180,1874730.0,14934,15128.75
1487,29,25,8,12,104,103,106,105,72,210,208,11024,1157520.0,10815,10920.0
1488,56,50,17,27,181,180,267,266,426,448,446,48327,10825248.0,47880,49952.0
1489,18,17,3,3,133,132,98,97,64,231,229,13034,1505427.0,12804,13224.75
149,44,35,14,30,150,149,116,115,88,266,264,17400,2314200.0,17135,17556.0
1490,41,33,14,27,96,95,198,197,121,294,292,19008,2794176.0,18715,21462.0
1491,49,47,13,15,121,120,237,236,181,358,356,28677,5133183.0,28320,31862.0
1492,54,46,17,29,192,191,132,131,205,324,322,25344,4105728.0,25021,26082.0
1493,64,53,19,38,118,117,140,139,98,258,256,16520,2131080.0,16263,16512.0
1494,61,53,12,23,183,182,115,114,110,298,296,21045,3135705.0,20748,22052.0
1495,42,38,8,14,113,112,90,89,40,203,201,10170,1032255.0,9968,10200.75
1496,31,24,11,21,169,168,112,111,119,281,279,18928,2659384.0,18648,19599.75
1497,90,74,26,54,194,193,253,252,332,447,445,49082,10969827.0,48636,49728.75
1498,55,51,16,22,157,156,186,185,163,343,341,29202,5008143.0,28860,29240.75
1499,108,94,38,64,395,394,255,254,741,650,648,100725,32735625.0,100076,105300.0
15,50,38,9,22,110,109,158,157,130,268,266,17380,2328920.0,17113,17822.0
1500,42,38,13,18,106,105,162,161,99,268,266,17172,2301048.0,16905,17822.0
1501,59,40,19,55,156,155,211,210,249,367,365,32916,6040086.0,32550,33488.75
1502,61,53,18,32,143,142,152,151,128,295,293,21736,3206060.0,21442,21608.75
1503,55,46,15,28,307,306,230,229,629,537,535,70610,18958785.0,70074,71823.75
1504,26,23,8,11,133,132,156,155,111,289,287,20748,2998086.0,20460,20735.75
1505,62,50,21,43,203,202,125,124,169,328,326,25375,4161500.0,25048,26732.0
1506,37,28,9,24,146,145,158,157,153,304,302,23068,3506336.0,22765,22952.0
1507,102,83,29,60,174,173,210,209,239,384,382,36540,7015680.0,36157,36672.0
1508,108,89,39,75,505,504,402,401,12793,907,905,203010,92065035.0,202104,205208.75
1509,58,46,16,38,152,151,90,89,79,242,240,13680,1655280.0,13439,14520.0
151,55,45,15,31,116,115,187,186,134,303,301,21692,3286338.0,21390,22800.75
1510,98,97,4,4,262,261,147,146,271,409,407,38514,7876113.0,38106,41615.75
1511,64,54,19,37,137,136,114,113,87,251,249,15618,1960059.0,15368,15624.75
1512,56,49,17,28,155,154,139,138,112,294,292,21545,3167115.0,21252,21462.0
1513,391,381,15,33,405,404,536,535,4752,941,939,217080,102136140.0,216140,220899.75
1514,80,67,23,46,168,167,164,163,205,332,330,27552,4573632.0,27221,27390.0
1515,55,36,19,53,302,301,279,278,1045,581,579,84258,24476949.0,83678,84099.75
1516,50,40,14,30,156,155,186,185,151,342,340,29016,4961736.0,28675,29070.0
1517,106,92,18,44,163,162,221,220,263,384,382,36023,6916416.0,35640,36672.0
1518,84,65,23,57,317,316,308,307,1147,625,623,97636,30511250.0,97012,97343.75
1519,60,54,15,25,146,145,96,95,70,242,240,14016,1695936.0,13775,14520.0
152,100,87,23,47,264,263,180,179,398,444,442,47520,10549440.0,47077,49062.0
1520,54,51,16,19,115,114,141,140,93,256,254,16215,2075520.0,15960,16256.0
1521,66,55,21,40,252,251,253,252,573,505,503,63756,16098390.0,63252,63503.75
1522,114,96,45,79,326,325,419,418,2027,745,743,136594,50881265.0,135850,138383.75
1523,48,37,16,32,183,182,285,284,405,468,466,52155,12204270.0,51688,54522.0
1524,76,66,24,42,157,156,257,256,249,414,412,40349,8352243.0,39936,42642.0
1525,62,56,20,30,181,180,108,107,101,289,287,19548,2824686.0,19260,20735.75
1526,63,61,13,15,122,121,167,166,84,289,287,20374,2944043.0,20086,20735.75
1527,69,56,17,41,139,138,223,222,280,362,360,30997,5610457.0,30636,32580.0
1528,84,80,15,21,134,133,125,124,86,259,257,16750,2169125.0,16492,16640.75
1529,53,45,19,28,294,293,345,344,878,639,637,101430,32406885.0,100792,101760.75
153,63,52,18,38,148,147,162,161,181,310,308,23976,3716280.0,23667,23870.0
1530,70,53,17,48,152,151,236,235,238,388,386,35872,6959168.0,35485,37442.0
1531,56,44,16,37,179,178,162,161,178,341,339,28998,4944159.0,28658,28899.75
1532,43,35,14,23,95,94,122,121,52,217,215,11590,1257515.0,11374,11663.75
1533,72,61,16,35,225,224,150,149,274,375,373,33750,6328125.0,33376,34968.75
1534,115,92,38,82,319,318,408,407,1359,727,725,130152,47310252.0,129426,131768.75
1535,47,46,10,10,89,88,105,104,40,194,192,9345,906465.0,9152,9312.0
1537,74,64,17,35,136,135,108,107,70,244,242,14688,1791936.0,14445,14762.0
1538,62,51,22,42,148,147,235,234,238,383,381,34780,6660370.0,34398,36480.75
1539,52,47,13,21,157,156,124,123,109,281,279,19468,2735254.0,19188,19599.75
154,74,64,25,42,494,493,382,381,2015,876,874,188708,82654104.0,187833,191406.0
1540,101,86,18,46,183,182,191,190,330,374,372,34953,6536211.0,34580,34782.0
1541,30,26,6,10,83,82,107,106,36,190,188,8881,843695.0,8692,8930.0
1542,79,66,29,52,129,128,268,267,371,397,395,34572,6862542.0,34176,39203.75
1543,60,51,21,37,155,154,145,144,125,300,298,22475,3371250.0,22176,22350.0
1544,65,53,11,32,112,111,134,133,85,246,244,15008,1845984.0,14763,15006.0
1545,79,67,24,46,221,220,201,200,369,422,420,44421,9372831.0,44000,44310.0
1546,50,43,13,25,267,266,209,208,551,476,474,55803,13281114.0,55328,56406.0
1547,98,77,22,62,199,198,241,240,410,440,438,47959,10550980.0,47520,48180.0
1548,46,36,10,25,142,141,96,95,73,238,236,13632,1622208.0,13395,14042.0
1549,86,78,18,30,119,118,223,222,194,342,340,26537,4537827.0,26196,29070.0
155,84,73,24,44,239,238,215,214,411,454,452,51385,11664395.0,50932,51302.0
1551,137,136,7,7,147,146,147,146,174,294,292,21609,3176523.0,21316,21462.0
1552,35,30,11,19,88,87,143,142,59,231,229,12584,1453452.0,12354,13224.75
1553,64,49,18,45,104,103,132,131,89,236,234,13728,1619904.0,13493,13806.0
1554,45,40,15,23,125,124,189,188,165,314,312,23625,3709125.0,23312,24492.0
1555,68,63,14,22,122,121,118,117,82,240,238,14396,1727520.0,14157,14280.0
1556,46,39,15,27,160,159,201,200,180,361,359,32160,5804880.0,31800,32399.75
1557,121,91,36,89,310,309,307,306,1098,617,615,95170,29359945.0,94554,94863.75
1558,26,18,8,21,421,420,123,122,581,544,542,51783,14084976.0,51240,73712.0
1559,42,39,16,19,92,91,98,97,34,190,188,9016,856520.0,8827,8930.0
156,93,81,29,51,146,145,202,201,210,348,346,29492,5131608.0,29145,30102.0
1560,217,213,18,24,354,353,308,307,2043,662,660,109032,36089592.0,108371,109230.0
1561,58,46,10,31,88,87,98,97,50,186,184,8624,802032.0,8439,8556.0
1562,36,23,8,26,159,158,140,139,168,299,297,22260,3327870.0,21962,22200.75
1563,77,68,14,26,147,146,121,120,103,268,266,17787,2383458.0,17520,17822.0
1564,50,45,11,19,80,79,87,86,35,167,165,6960,581160.0,6794,6888.75
1565,64,57,18,30,92,91,153,152,65,245,243,14076,1724310.0,13832,14883.75
1566,45,39,17,27,128,127,185,184,127,313,311,23680,3705920.0,23368,24335.75
1567,59,54,17,24,126,125,91,90,72,217,215,11466,1244061.0,11250,11663.75
1568,26,24,8,10,167,166,75,74,85,242,240,12525,1515525.0,12284,14520.0
1569,45,37,13,20,181,180,206,205,376,387,385,37286,7214841.0,36900,37248.75
157,23,21,7,9,96,95,128,127,52,224,222,12288,1376256.0,12065,12432.0
1570,118,88,43,101,239,238,264,263,619,503,501,63096,15868644.0,62594,63000.75
1571,70,62,19,32,143,142,140,139,120,283,281,20020,2832830.0,19738,19880.75
1572,76,61,18,45,204,203,256,255,640,460,458,52224,12011520.0,51765,52670.0
1573,34,25,14,29,169,168,168,167,252,337,335,28392,4784052.0,28056,28223.75
1574,74,60,19,42,273,272,170,169,474,443,441,46410,10279815.0,45968,48840.75
1575,80,71,21,37,135,134,142,141,103,277,275,19170,2655045.0,18894,19043.75
1576,69,56,23,47,330,329,339,338,1214,669,667,111870,37420515.0,111202,111555.75
1577,60,46,21,46,267,266,275,274,524,542,540,73425,19898175.0,72884,73170.0
1578,38,32,15,25,102,101,185,184,87,287,285,18870,2707845.0,18584,20448.75
1579,50,39,19,38,169,168,141,140,169,310,308,23829,3693495.0,23520,23870.0
158,81,72,23,38,138,137,197,196,140,335,333,27186,4553655.0,26852,27888.75
1580,49,34,15,43,111,110,183,182,124,294,292,20313,2986011.0,20020,21462.0
1581,100,85,31,56,249,248,294,293,601,543,541,73206,19875429.0,72664,73440.75
1582,54,49,14,20,132,131,117,116,97,249,247,15444,1922778.0,15196,15375.75
1583,60,53,16,26,147,146,151,150,120,298,296,22197,3307353.0,21900,22052.0
1585,31,26,7,12,93,92,106,105,57,199,197,9858,980871.0,9660,9800.75
1587,54,43,18,36,154,153,325,324,540,479,477,50050,11986975.0,49572,57120.75
1588,51,42,13,29,243,242,245,244,508,488,486,59535,14526540.0,59048,59292.0
1589,46,37,15,29,108,107,124,123,69,232,230,13392,1553472.0,13161,13340.0
159,181,176,19,27,253,252,237,236,438,490,488,59961,14690445.0,59472,59780.0
1590,54,48,17,27,121,120,103,102,60,224,222,12463,1395856.0,12240,12432.0
1592,46,32,15,41,159,158,168,167,183,327,325,26712,4367412.0,26386,26568.75
1593,41,32,14,28,140,139,108,107,117,248,246,15120,1874880.0,14873,15252.0
1594,59,51,20,34,171,170,132,131,123,303,301,22572,3419658.0,22270,22800.75
1595,66,58,13,26,165,164,205,204,279,370,368,33825,6257625.0,33456,34040.0
1596,58,43,18,46,162,161,235,234,240,397,395,38070,7556895.0,37674,39203.75
1597,51,41,11,29,126,125,179,178,182,305,303,22554,3439485.0,22250,23103.75
1598,58,48,16,34,120,119,119,118,72,239,237,14280,1706460.0,14042,14160.75
1599,100,82,38,71,390,389,217,216,1108,607,605,84630,25685205.0,84024,91808.75
16,64,52,22,44,299,298,199,198,507,498,496,59501,14815749.0,59004,61752.0
160,67,54,22,46,130,129,287,286,495,417,415,37310,7779135.0,36894,43263.75
1600,43,42,7,7,191,190,138,137,153,329,327,26358,4335891.0,26030,26895.75
1601,84,70,20,41,141,140,144,143,132,285,283,20304,2893320.0,20020,20163.75
1602,38,26,8,27,106,105,120,119,111,226,224,12720,1437360.0,12495,12656.0
1603,36,34,17,19,286,285,105,104,244,391,389,30030,5870865.0,29640,38024.75
1604,61,57,15,21,281,280,252,251,633,533,531,70812,18871398.0,70280,70755.75
1605,37,31,12,20,103,102,131,130,58,234,232,13493,1578681.0,13260,13572.0
1606,56,53,17,21,122,121,114,113,68,236,234,13908,1641144.0,13673,13806.0
1607,51,45,12,21,183,182,106,105,98,289,287,19398,2803011.0,19110,20735.75
1608,59,54,12,20,125,124,160,159,154,285,283,20000,2850000.0,19716,20163.75
1609,59,47,21,43,231,230,155,154,240,386,384,35805,6910365.0,35420,37056.0
161,42,40,11,13,138,137,144,143,138,282,280,19872,2801952.0,19591,19740.0
1610,22,20,8,9,145,144,185,184,147,330,328,26825,4426125.0,26496,27060.0
1611,83,70,26,49,238,237,216,215,412,454,452,51408,11669616.0,50955,51302.0
1612,46,40,15,25,133,132,184,183,149,317,315,24472,3878812.0,24156,24963.75
1613,56,48,21,34,123,122,130,129,84,253,251,15990,2022735.0,15738,15875.75
1614,63,54,19,34,185,184,137,136,190,322,320,25345,4080545.0,25024,25760.0
1615,89,73,21,51,138,137,207,206,297,345,343,28566,4927635.0,28222,29583.75
1616,60,53,17,29,161,160,145,144,170,306,304,23345,3571785.0,23040,23256.0
1617,71,56,17,44,158,157,157,156,143,315,313,24806,3906945.0,24492,24648.75
1619,103,89,23,47,178,177,250,249,310,428,426,44500,9523000.0,44073,45582.0
162,66,62,10,16,98,97,79,78,31,177,175,7742,685167.0,7566,7743.75
1620,36,30,10,20,123,122,134,133,99,257,255,16482,2117937.0,16226,16383.75
1621,105,101,10,16,124,123,178,177,116,302,300,22072,3332872.0,21771,22650.0
1622,62,58,19,24,138,137,192,191,143,330,328,26496,4371840.0,26167,27060.0
1623,36,30,12,22,143,142,103,102,69,246,244,14729,1811667.0,14484,15006.0
1624,92,75,21,53,213,212,235,234,582,448,446,50055,11212320.0,49608,49952.0
1625,49,36,18,42,235,234,243,242,499,478,476,57105,13648095.0,56628,56882.0
1626,56,49,16,28,259,258,115,114,188,374,372,29785,5569795.0,29412,34782.0
1627,52,39,19,41,269,268,160,159,295,429,427,43040,9232080.0,42612,45795.75
1628,44,29,12,39,165,164,98,97,97,263,261,16170,2126355.0,15908,17160.75
1629,101,78,32,73,400,399,513,512,4863,913,911,205200,93673800.0,204288,207935.75
163,63,51,14,36,140,139,112,111,93,252,250,15680,1975680.0,15429,15750.0
1630,107,84,41,84,236,235,533,532,1271,769,767,125788,48365486.0,125020,147455.75
1631,39,36,11,14,202,201,185,184,291,387,385,37370,7231095.0,36984,37248.75
1632,64,44,14,49,156,155,116,115,126,272,270,18096,2461056.0,17825,18360.0
1633,59,50,18,34,232,231,163,162,282,395,393,37816,7468660.0,37422,38808.75
1634,44,36,12,25,259,258,164,163,293,423,421,42476,8983674.0,42054,44520.75
1635,123,111,31,52,282,281,234,233,644,516,514,65988,17024904.0,65473,66306.0
1636,115,107,30,44,226,225,281,280,576,507,505,63506,16098771.0,63000,64008.75
1637,54,47,14,24,100,99,112,111,100,212,210,11200,1187200.0,10989,11130.0
1638,55,43,17,39,245,244,202,201,578,447,445,49490,11061015.0,49044,49728.75
1639,60,49,20,40,257,256,171,170,270,428,426,43947,9404658.0,43520,45582.0
164,72,63,16,27,447,446,274,273,1116,721,719,122478,44153319.0,121758,129599.75
1640,113,79,31,96,265,264,206,205,514,471,469,54590,12855945.0,54120,55224.75
1641,43,32,12,32,83,82,77,76,24,160,158,6391,511280.0,6232,6320.0
1642,28,24,9,12,125,124,304,303,319,429,427,38000,8151000.0,37572,45795.75
1643,53,46,14,26,147,146,126,125,97,273,271,18522,2528253.0,18250,18495.75
1644,78,65,22,44,141,140,111,110,123,252,250,15651,1972026.0,15400,15750.0
1645,46,38,13,24,116,115,91,90,82,207,205,10556,1092546.0,10350,10608.75
1646,65,50,19,46,246,245,252,251,601,498,496,61992,15436008.0,61495,61752.0
1647,257,256,10,10,267,266,267,266,603,534,532,71289,19034163.0,70756,71022.0
1648,95,94,3,3,124,123,101,100,56,225,223,12524,1408950.0,12300,12543.75
1649,48,41,17,28,130,129,121,120,63,251,249,15730,1974115.0,15480,15624.75
165,57,43,21,47,156,155,142,141,140,298,296,22152,3300648.0,21855,22052.0
1650,29,24,10,18,150,149,179,178,193,329,327,26850,4416825.0,26522,26895.75
1652,70,61,24,39,204,203,180,179,268,384,382,36720,7050240.0,36337,36672.0
1654,27,23,8,12,268,267,324,323,894,592,590,86832,25702272.0,86241,87320.0
1655,73,57,22,50,225,224,299,298,677,524,522,67275,17626050.0,66752,68382.0
1657,50,40,20,38,165,164,329,328,440,494,492,54285,13408395.0,53792,60762.0
1658,40,33,14,24,77,76,169,168,67,246,244,13013,1600599.0,12768,15006.0
1659,139,106,49,113,394,393,320,319,1998,714,712,126080,45010560.0,125367,127092.0
166,44,42,14,16,171,170,194,193,218,365,363,33174,6054255.0,32810,33123.75
1660,29,20,10,24,166,165,115,114,137,281,279,19090,2682145.0,18810,19599.75
1661,50,44,13,21,95,94,136,135,58,231,229,12920,1492260.0,12690,13224.75
1662,33,31,8,10,130,129,113,112,70,243,241,14690,1784835.0,14448,14640.75
1663,101,80,17,55,158,157,223,222,310,381,379,35234,6712077.0,34854,36099.75
1664,74,58,21,49,178,177,137,136,156,315,313,24386,3840795.0,24072,24648.75
1665,60,53,23,35,226,225,345,344,708,571,569,77970,22260435.0,77400,81224.75
1666,105,101,10,16,124,123,178,177,115,302,300,22072,3332872.0,21771,22650.0
1667,42,34,16,30,463,462,215,214,948,678,676,99545,33745755.0,98868,114582.0
1668,44,37,12,22,93,92,113,112,49,206,204,10509,1082427.0,10304,10506.0
1669,74,61,25,48,188,187,189,188,186,377,375,35532,6697782.0,35156,35343.75
167,77,71,19,27,153,152,181,180,174,334,332,27693,4624731.0,27360,27722.0
1671,46,34,13,34,166,165,146,145,193,312,310,24236,3780816.0,23925,24180.0
1672,129,113,39,67,295,294,272,271,749,567,565,80240,22748040.0,79674,80088.75
1673,76,62,25,51,167,166,192,191,264,359,357,32064,5755488.0,31706,32040.75
1674,67,61,20,29,132,131,217,216,201,349,347,28644,4998378.0,28296,30275.75
1675,102,80,32,73,266,265,276,275,582,542,540,73416,19895736.0,72875,73170.0
1676,29,27,9,10,173,172,122,121,120,295,293,21106,3113135.0,20812,21608.75
1677,57,51,15,25,108,107,99,98,52,207,205,10692,1106622.0,10486,10608.75
1678,57,51,18,28,115,114,185,184,151,300,298,21275,3191250.0,20976,22350.0
1679,78,65,20,44,231,230,213,212,281,444,442,49203,10923066.0,48760,49062.0
168,41,35,13,22,116,115,106,105,73,222,220,12296,1364856.0,12075,12210.0
1680,36,32,6,9,98,97,149,148,101,247,245,14602,1803347.0,14356,15128.75
1681,54,47,16,28,121,120,106,105,67,227,225,12826,1455751.0,12600,12768.75
1682,76,58,29,62,219,218,224,223,309,443,441,49056,10865904.0,48614,48840.75
1683,48,45,12,16,91,90,135,134,69,226,224,12285,1388205.0,12060,12656.0
1684,86,70,22,52,143,142,230,229,222,373,371,32890,6133985.0,32518,34595.75
1685,97,83,27,53,261,260,241,240,478,502,500,62901,15788151.0,62400,62750.0
1686,48,43,12,20,117,116,219,218,171,336,334,25623,4304664.0,25288,28056.0
1687,79,72,16,27,197,196,158,157,260,355,353,31126,5524865.0,30772,31328.75
1688,42,36,13,21,110,109,181,180,105,291,289,19910,2896905.0,19620,21024.75
1689,90,67,34,78,241,240,345,344,734,586,584,83145,24361485.0,82560,85556.0
169,48,36,13,35,157,156,119,118,103,276,274,18683,2578254.0,18408,18906.0
1690,135,117,42,75,309,308,457,456,1418,766,764,141213,54084579.0,140448,146306.0
1691,46,41,15,23,201,200,127,126,127,328,326,25527,4186428.0,25200,26732.0
1692,108,96,24,41,248,247,188,187,302,436,434,46624,10164032.0,46189,47306.0
1693,74,64,16,33,161,160,180,179,154,341,339,28980,4941090.0,28640,28899.75
1694,182,180,14,16,262,261,216,215,692,478,476,56592,13525488.0,56115,56882.0
1695,47,36,16,35,136,135,213,212,164,349,347,28968,5054916.0,28620,30275.75
1696,68,51,15,45,260,259,241,240,550,501,499,62660,15696330.0,62160,62499.75
1697,46,41,17,21,178,177,137,136,168,315,313,24386,3840795.0,24072,24648.75
1698,56,51,11,17,103,102,136,135,62,239,237,14008,1673956.0,13770,14160.75
1699,55,44,16,36,110,109,164,163,142,274,272,18040,2471480.0,17767,18632.0
17,43,36,13,25,80,79,137,136,59,217,215,10960,1189160.0,10744,11663.75
170,55,51,22,27,171,170,155,154,153,326,324,26505,4320315.0,26180,26406.0
1700,37,30,10,22,182,181,105,104,117,287,285,19110,2742285.0,18824,20448.75
1701,63,56,17,26,155,154,154,153,143,309,307,23870,3687915.0,23562,23715.75
1702,84,72,21,40,142,141,145,144,141,287,285,20590,2954665.0,20304,20448.75
1703,34,27,9,18,144,143,86,85,71,230,228,12384,1424160.0,12155,13110.0
1704,91,75,24,54,188,187,162,161,156,350,348,30456,5329800.0,30107,30450.0
1705,76,65,21,41,117,116,251,250,154,368,366,29367,5403528.0,29000,33672.0
1706,90,73,25,54,271,270,271,270,763,542,540,73441,19902511.0,72900,73170.0
1707,107,91,29,56,267,266,284,283,893,551,549,75828,20890614.0,75278,75624.75
1708,71,54,19,50,162,161,223,222,255,385,383,36126,6954255.0,35742,36863.75
1709,61,54,16,28,129,128,224,223,245,353,351,28896,5100144.0,28544,30975.75
171,82,69,21,45,148,147,211,210,212,359,357,31228,5605426.0,30870,32040.75
1710,43,32,11,31,192,191,253,252,418,445,443,48576,10808160.0,48132,49283.75
1711,36,33,11,13,533,532,208,207,1025,741,739,110864,41075112.0,110124,136899.75
1712,89,73,26,55,157,156,229,228,250,386,384,35953,6938929.0,35568,37056.0
1713,57,48,16,32,146,145,193,192,191,339,337,28178,4776171.0,27840,28560.75
1714,131,100,42,101,266,265,370,369,1307,636,634,98420,31297560.0,97785,100806.0
1715,38,31,12,23,105,104,173,172,112,278,276,18165,2524935.0,17888,19182.0
1716,81,62,24,58,178,177,183,182,304,361,359,32574,5879607.0,32214,32399.75
1717,28,23,10,18,129,128,156,155,126,285,283,20124,2867670.0,19840,20163.75
1718,83,72,21,41,126,125,174,173,131,300,298,21924,3288600.0,21625,22350.0
1719,69,52,25,57,247,246,210,209,379,457,455,51870,11852295.0,51414,51983.75
172,79,64,18,46,251,250,144,143,239,395,393,36144,7138440.0,35750,38808.75
1720,51,46,11,19,82,81,144,143,51,226,224,11808,1334304.0,11583,12656.0
1721,46,43,8,11,94,93,166,165,72,260,258,15604,2028520.0,15345,16770.0
1722,80,70,25,42,152,151,212,211,196,364,362,32224,5864768.0,31861,32942.0
1724,34,27,12,24,98,97,146,145,91,244,242,14308,1745576.0,14065,14762.0
1725,45,34,11,31,151,150,147,146,174,298,296,22197,3307353.0,21900,22052.0
1726,62,50,18,37,120,119,155,154,105,275,273,18600,2557500.0,18326,18768.75
1727,36,23,10,29,97,96,125,124,58,222,220,12125,1345875.0,11904,12210.0
1728,97,83,24,50,256,255,267,266,523,523,521,68352,17874048.0,67830,68120.75
1729,28,22,5,13,108,107,107,106,50,215,213,11556,1242270.0,11342,11448.75
173,117,105,26,46,255,254,173,172,252,428,426,44115,9440610.0,43688,45582.0
1730,45,40,18,26,220,219,130,129,149,350,348,28600,5005000.0,28251,30450.0
1731,34,27,9,19,256,255,308,307,901,564,562,78848,22235136.0,78285,79242.0
1732,64,58,17,27,167,166,127,126,164,294,292,21209,3117723.0,20916,21462.0
1733,37,28,11,25,140,139,133,132,124,273,271,18620,2541630.0,18348,18495.75
1734,35,28,8,19,110,109,82,81,33,192,190,9020,865920.0,8829,9120.0
1735,47,35,12,32,124,123,111,110,66,235,233,13764,1617270.0,13530,13688.75
1736,19,18,6,6,240,239,127,126,190,367,365,30480,5593080.0,30114,33488.75
1737,56,45,12,32,126,125,179,178,130,305,303,22554,3439485.0,22250,23103.75
1738,69,57,16,38,136,135,134,133,124,270,268,18224,2460240.0,17955,18090.0
1739,65,55,23,40,181,180,111,110,117,292,290,20091,2933286.0,19800,21170.0
174,56,50,15,23,130,129,165,164,132,295,293,21450,3163875.0,21156,21608.75
1740,26,23,5,8,121,120,78,77,40,199,197,9438,939081.0,9240,9800.75
1741,32,29,8,11,178,177,189,188,247,367,365,33642,6173307.0,33276,33488.75
1742,49,47,15,16,166,165,112,111,111,278,276,18592,2584288.0,18315,19182.0
1743,75,59,22,52,181,180,128,127,143,309,307,23168,3579456.0,22860,23715.75
1744,33,23,6,16,86,85,114,113,74,200,198,9804,980400.0,9605,9900.0
1745,78,66,30,52,192,191,146,145,192,338,336,28032,4737408.0,27695,28392.0
1746,34,31,13,16,153,152,189,188,150,342,340,28917,4944807.0,28576,29070.0
1747,50,38,13,32,114,113,277,276,303,391,389,31578,6173499.0,31188,38024.75
1748,63,47,18,46,158,157,103,102,85,261,259,16274,2123757.0,16014,16899.75
1749,34,30,13,18,134,133,150,149,102,284,282,20100,2854200.0,19817,20022.0
175,181,158,45,88,373,372,528,527,3131,901,899,196944,88723272.0,196044,202499.75
1750,36,32,9,15,125,124,118,117,61,243,241,14750,1792125.0,14508,14640.75
1752,110,91,32,68,427,426,369,368,1966,796,794,157563,62710074.0,156768,158006.0
1754,46,41,10,16,102,101,259,258,165,361,359,26418,4768449.0,26058,32399.75
1755,26,23,10,12,90,89,230,229,147,320,318,20700,3312000.0,20381,25440.0
1756,40,34,15,25,148,147,103,102,85,251,249,15244,1913122.0,14994,15624.75
1757,74,68,23,33,196,195,116,115,157,312,310,22736,3546816.0,22425,24180.0
1758,48,42,15,25,206,205,141,140,251,347,345,29046,5039481.0,28700,29928.75
1759,52,47,17,22,149,148,125,124,86,274,272,18625,2551625.0,18352,18632.0
176,82,76,13,23,162,161,206,205,181,368,366,33372,6140448.0,33005,33672.0
1762,98,78,24,62,242,241,187,186,319,429,427,45254,9706983.0,44826,45795.75
1763,78,55,24,67,262,261,296,295,683,558,556,77552,21637008.0,76995,77562.0
1764,83,64,18,52,145,144,275,274,327,420,418,39875,8373750.0,39456,43890.0
1765,56,42,17,37,140,139,116,115,137,256,254,16240,2078720.0,15985,16256.0
1766,22,18,5,10,164,163,182,181,204,346,344,29848,5163704.0,29503,29756.0
1768,41,31,13,31,88,87,100,99,65,188,186,8800,827200.0,8613,8742.0
1769,52,41,13,31,122,121,137,136,97,259,257,16714,2164463.0,16456,16640.75
177,63,55,17,31,127,126,205,204,154,332,330,26035,4321810.0,25704,27390.0
1770,69,58,21,41,155,154,271,270,283,426,424,42005,8947065.0,41580,45156.0
1771,42,34,14,28,189,188,184,183,217,373,371,34776,6485724.0,34404,34595.75
1772,50,43,17,29,146,145,267,266,307,413,411,38982,8049783.0,38570,42435.75
1773,53,41,16,38,123,122,94,93,81,217,215,11562,1254477.0,11346,11663.75
1774,41,34,15,27,185,184,88,87,86,273,271,16280,2222220.0,16008,18495.75
1775,56,48,15,29,126,125,127,126,115,253,251,16002,2024253.0,15750,15875.75
1776,56,47,21,35,222,221,129,128,174,351,349,28638,5025969.0,28288,30624.75
1777,66,55,18,32,137,136,154,153,111,291,289,21098,3069759.0,20808,21024.75
1778,75,65,21,39,128,127,139,138,81,267,265,17792,2375232.0,17526,17688.75
1779,36,26,9,22,75,74,111,110,36,186,184,8325,774225.0,8140,8556.0
178,49,40,14,26,146,145,162,161,148,308,306,23652,3642408.0,23345,23562.0
1780,56,50,16,26,180,179,144,143,138,324,322,25920,4199040.0,25597,26082.0
1781,46,40,16,24,131,130,125,124,80,256,254,16375,2096000.0,16120,16256.0
1782,49,41,18,29,321,320,190,189,580,511,509,60990,15582945.0,60480,65024.75
1783,32,30,12,14,131,130,103,102,74,234,232,13493,1578681.0,13260,13572.0
1784,48,43,14,21,132,131,96,95,66,228,226,12672,1444608.0,12445,12882.0
1785,87,74,28,52,241,240,199,198,362,440,438,47959,10550980.0,47520,48180.0
1786,68,53,20,44,147,146,145,144,154,292,290,21315,3111990.0,21024,21170.0
1787,31,25,7,13,115,114,229,228,202,344,342,26335,4529620.0,25992,29412.0
1788,51,39,14,33,127,126,148,147,114,275,273,18796,2584450.0,18522,18768.75
1789,33,29,6,11,142,141,155,154,233,297,295,22010,3268485.0,21714,21903.75
179,24,21,10,13,226,225,167,166,204,393,391,37742,7416303.0,37350,38415.75
1791,75,63,23,45,157,156,236,235,264,393,391,37052,7280718.0,36660,38415.75
1792,39,34,11,18,141,140,130,129,104,271,269,18330,2483715.0,18060,18224.75
1793,83,74,31,46,234,233,214,213,414,448,446,50076,11217024.0,49629,49952.0
1794,64,54,18,30,268,267,188,187,558,456,454,50384,11487552.0,49929,51756.0
1795,60,50,26,43,460,459,374,373,1474,834,832,172040,71740680.0,171207,173472.0
1796,40,31,11,26,132,131,82,81,59,214,212,10824,1158168.0,10611,11342.0
1797,58,45,17,38,178,177,145,144,209,323,321,25810,4168315.0,25488,25920.75
1798,36,30,10,16,214,213,217,216,298,431,429,46438,10007389.0,46008,46224.75
1799,42,32,10,26,169,168,117,116,123,286,284,19773,2827539.0,19488,20306.0
18,23,20,5,8,395,394,252,251,699,647,645,99540,32201190.0,98894,104328.75
180,61,55,19,29,216,215,167,166,215,383,381,36072,6907788.0,35690,36480.75
1800,29,25,10,15,147,146,91,90,63,238,236,13377,1591863.0,13140,14042.0
1801,127,98,43,97,265,264,246,245,603,511,509,65190,16656045.0,64680,65024.75
1802,50,41,14,30,146,145,125,124,119,271,269,18250,2472875.0,17980,18224.75
1803,53,49,16,21,196,195,121,120,138,317,315,23716,3758986.0,23400,24963.75
1804,77,67,21,39,266,265,126,125,202,392,390,33516,6569136.0,33125,38220.0
1805,86,72,28,54,247,246,168,167,318,415,413,41496,8610420.0,41082,42848.75
1807,36,34,11,13,158,157,133,132,117,291,289,21014,3057537.0,20724,21024.75
1808,54,42,13,35,146,145,124,123,93,270,268,18104,2444040.0,17835,18090.0
1809,61,57,21,27,169,168,193,192,196,362,360,32617,5903677.0,32256,32580.0
181,65,54,21,40,154,153,293,292,302,447,445,45122,10084767.0,44676,49728.75
1810,23,22,7,7,200,199,110,109,109,310,308,22000,3410000.0,21691,23870.0
1811,68,57,23,40,218,217,155,154,300,373,371,33790,6301835.0,33418,34595.75
1812,73,64,19,35,114,113,158,157,114,272,270,18012,2449632.0,17741,18360.0
1813,82,73,24,39,247,246,201,200,351,448,446,49647,11120928.0,49200,49952.0
1815,68,54,19,45,140,139,207,206,257,347,345,28980,5028030.0,28634,29928.75
1816,36,26,8,24,100,99,93,92,49,193,191,9300,897450.0,9108,9215.75
1817,76,69,22,34,139,138,235,234,205,374,372,32665,6108355.0,32292,34782.0
1819,98,87,20,39,220,219,182,181,279,402,400,40040,8048040.0,39639,40200.0
182,62,49,16,39,129,128,119,118,111,248,246,15351,1903524.0,15104,15252.0
1820,58,45,17,40,110,109,116,115,66,226,224,12760,1441880.0,12535,12656.0
1821,61,45,14,43,158,157,107,106,118,265,263,16906,2240045.0,16642,17423.75
1822,60,49,21,40,158,157,112,111,99,270,268,17696,2388960.0,17427,18090.0
1823,77,68,25,41,155,154,141,140,133,296,294,21855,3234540.0,21560,21756.0
1824,152,151,11,11,170,169,170,169,192,340,338,28900,4913000.0,28561,28730.0
1825,84,75,13,28,116,115,196,195,190,312,310,22736,3546816.0,22425,24180.0
1826,34,27,11,20,146,145,88,87,61,234,232,12848,1503216.0,12615,13572.0
1827,111,81,31,89,324,323,313,312,1491,637,635,101412,32299722.0,100776,101123.75
1828,79,68,32,51,359,358,242,241,679,601,599,86878,26106839.0,86278,89999.75
1829,29,24,7,13,69,68,161,160,72,230,228,11109,1277535.0,10880,13110.0
183,41,36,12,19,123,122,220,219,137,343,341,27060,4640790.0,26718,29240.75
1830,50,43,18,30,210,209,246,245,421,456,454,51660,11778480.0,51205,51756.0
1831,75,67,21,35,119,118,149,148,98,268,266,17731,2375954.0,17464,17822.0
1832,155,116,54,130,537,536,394,393,2454,931,929,211578,98489559.0,210648,216224.75
1833,69,61,21,35,103,102,190,189,121,293,291,19570,2867005.0,19278,21315.75
1835,42,33,13,29,131,130,77,76,58,208,206,10087,1049048.0,9880,10712.0
1836,70,59,24,44,154,153,264,263,370,418,416,40656,8497104.0,40239,43472.0
1837,55,43,19,38,179,178,148,147,176,327,325,26492,4331442.0,26166,26568.75
1838,47,40,12,23,171,170,98,97,119,269,267,16758,2253951.0,16490,17955.75
1839,71,57,19,37,255,254,324,323,897,579,577,82620,23918490.0,82042,83520.75
184,56,44,17,39,169,168,205,204,208,374,372,34645,6478615.0,34272,34782.0
1840,76,68,20,34,153,152,127,126,93,280,278,19431,2720340.0,19152,19460.0
1841,92,80,27,48,172,171,315,314,535,487,485,54180,13192830.0,53694,59048.75
1842,54,45,16,32,103,102,167,166,158,270,268,17201,2322135.0,16932,18090.0
1843,51,48,17,21,110,109,155,154,98,265,263,17050,2259125.0,16786,17423.75
1844,46,37,15,24,236,235,161,160,222,397,395,37996,7542206.0,37600,39203.75
1845,84,66,25,57,248,247,406,405,1675,654,652,100688,32924976.0,100035,106602.0
1846,59,53,16,26,115,114,121,120,54,236,234,13915,1641970.0,13680,13806.0
1847,42,37,10,18,163,162,91,90,78,254,252,14833,1883791.0,14580,16002.0
1848,59,49,17,33,160,159,124,123,84,284,282,19840,2817280.0,19557,20022.0
1849,140,139,8,8,147,146,331,330,365,478,476,48657,11629023.0,48180,56882.0
1850,37,33,12,17,128,127,180,179,149,308,306,23040,3548160.0,22733,23562.0
1851,58,52,15,25,134,133,150,149,116,284,282,20100,2854200.0,19817,20022.0
1852,65,45,25,57,185,184,276,275,385,461,459,51060,11769330.0,50600,52899.75
1853,56,42,18,40,143,142,135,134,114,278,276,19305,2683395.0,19028,19182.0
1854,45,34,15,32,121,120,94,93,70,215,213,11374,1222705.0,11160,11448.75
1855,133,115,49,82,393,392,262,261,1460,655,653,102966,33721365.0,102312,106928.75
1856,43,33,14,27,132,131,191,190,157,323,321,25212,4071738.0,24890,25920.75
1857,57,43,23,49,102,101,157,156,103,259,257,16014,2073813.0,15756,16640.75
1858,64,60,16,21,136,135,133,132,87,269,267,18088,2432836.0,17820,17955.75
1859,75,65,22,40,111,110,193,192,129,304,302,21423,3256296.0,21120,22952.0
186,43,38,15,23,136,135,134,133,108,270,268,18224,2460240.0,17955,18090.0
1860,71,57,22,48,345,344,184,183,603,529,527,63480,16790460.0,62952,69695.75
1861,153,136,39,71,411,410,258,257,1620,669,667,106038,35469711.0,105370,111555.75
1862,50,45,16,24,123,122,120,119,147,243,241,14760,1793340.0,14518,14640.75
1863,81,64,26,56,269,268,230,229,567,499,497,61870,15436565.0,61372,62000.75
1864,58,53,14,21,119,118,168,167,104,287,285,19992,2868852.0,19706,20448.75
1865,39,29,9,22,168,167,124,123,154,292,290,20832,3041472.0,20541,21170.0
1866,155,131,55,101,518,517,384,383,2329,902,900,198912,89709312.0,198011,202950.0
1867,76,63,27,51,220,219,159,158,242,379,377,34980,6628710.0,34602,35720.75
1868,46,34,13,34,156,155,147,146,175,303,301,22932,3474198.0,22630,22800.75
1869,37,31,12,22,171,170,118,117,116,289,287,20178,2915721.0,19890,20735.75
187,35,34,9,9,123,122,94,93,63,217,215,11562,1254477.0,11346,11663.75
1870,87,76,27,46,447,446,290,289,4089,737,735,129630,47768655.0,128894,135423.75
1871,48,42,13,22,161,160,190,189,194,351,349,30590,5368545.0,30240,30624.75
1872,42,34,15,27,208,207,440,439,1042,648,646,91520,29652480.0,90873,104652.0
1873,99,86,22,44,250,249,178,177,323,428,426,44500,9523000.0,44073,45582.0
1874,64,57,14,25,166,165,141,140,121,307,305,23406,3592821.0,23100,23408.75
1875,72,65,21,32,194,193,117,116,141,311,309,22698,3529539.0,22388,24024.75
1876,44,31,13,37,147,146,175,174,236,322,320,25725,4141725.0,25404,25760.0
1877,114,91,38,82,309,308,339,338,1803,648,646,104751,33939324.0,104104,104652.0
1878,121,93,33,87,237,236,243,242,520,480,478,57591,13821840.0,57112,57360.0
1879,47,35,11,33,132,131,149,148,192,281,279,19668,2763354.0,19388,19599.75
188,80,69,26,46,140,139,198,197,203,338,336,27720,4684680.0,27383,28392.0
1880,44,31,12,35,166,165,197,196,220,363,361,32702,5935413.0,32340,32760.75
1881,48,43,13,19,150,149,93,92,57,243,241,13950,1694925.0,13708,14640.75
1882,76,67,18,34,122,121,212,211,159,334,332,25864,4319288.0,25531,27722.0
1883,110,104,15,25,223,222,147,146,205,370,368,32781,6064485.0,32412,34040.0
1884,30,26,9,15,98,97,84,83,32,182,180,8232,749112.0,8051,8190.0
1885,54,48,16,23,119,118,221,220,193,340,338,26299,4470830.0,25960,28730.0
1886,58,51,11,22,470,469,256,255,1293,726,724,120320,43676160.0,119595,131406.0
1887,56,40,20,49,253,252,446,445,1008,699,697,112838,39436881.0,112140,121800.75
1888,119,118,6,6,124,123,147,146,93,271,269,18228,2469894.0,17958,18224.75
1889,41,38,10,13,188,187,252,251,355,440,438,47376,10422720.0,46937,48180.0
189,43,33,13,24,343,342,145,144,355,488,486,49735,12135340.0,49248,59292.0
1890,58,50,21,35,340,339,375,374,1906,715,713,127500,45581250.0,126786,127448.75
1892,43,31,13,28,185,184,252,251,437,437,435,46620,10186470.0,46184,47523.75
1893,107,103,11,17,262,261,178,177,383,440,438,46636,10259920.0,46197,48180.0
1894,61,49,19,41,239,238,149,148,211,388,386,35611,6908534.0,35224,37442.0
1895,171,170,7,7,178,177,178,177,170,356,354,31684,5639752.0,31329,31506.0
1896,36,33,13,17,367,366,218,217,614,585,583,80006,23401755.0,79422,85263.75
1897,124,107,34,66,205,204,267,266,396,472,470,54735,12917460.0,54264,55460.0
1898,257,256,10,10,267,266,267,266,597,534,532,71289,19034163.0,70756,71022.0
19,104,99,9,17,178,177,124,123,115,302,300,22072,3332872.0,21771,22650.0
190,57,44,16,37,123,122,138,137,164,261,259,16974,2215107.0,16714,16899.75
1900,74,59,26,52,185,184,240,239,337,425,423,44400,9435000.0,43976,44943.75
1901,31,27,11,15,167,166,106,105,76,273,271,17702,2416323.0,17430,18495.75
1902,66,55,17,37,108,107,155,154,108,263,261,16740,2201310.0,16478,17160.75
1903,121,105,40,70,463,462,248,247,1042,711,709,114824,40819932.0,114114,126024.75
1904,72,68,17,23,102,101,179,178,126,281,279,18258,2565249.0,17978,19599.75
1905,50,35,21,47,258,257,300,299,745,558,556,77400,21594600.0,76843,77562.0
1906,58,49,13,27,130,129,146,145,131,276,274,18980,2619240.0,18705,18906.0
1907,84,69,22,50,175,174,134,133,137,309,307,23450,3623025.0,23142,23715.75
1908,43,37,16,26,206,205,96,95,111,302,300,19776,2986176.0,19475,22650.0
1909,86,67,28,61,187,186,222,221,325,409,407,41514,8489613.0,41106,41615.75
191,80,61,23,52,183,182,177,176,200,360,358,32391,5830380.0,32032,32220.0
1910,39,36,8,12,107,106,142,141,77,249,247,15194,1891653.0,14946,15375.75
1911,75,68,20,30,215,214,207,206,335,422,420,44505,9390555.0,44084,44310.0
1912,71,58,21,45,149,148,198,197,204,347,345,29502,5118597.0,29156,29928.75
1913,25,20,7,12,185,184,149,148,144,334,332,27565,4603355.0,27232,27722.0
1914,60,53,17,29,221,220,102,101,132,323,321,22542,3640533.0,22220,25920.75
1915,76,66,11,24,152,151,142,141,132,294,292,21584,3172848.0,21291,21462.0
1916,60,47,19,43,111,110,180,179,155,291,289,19980,2907090.0,19690,21024.75
1917,35,30,8,16,72,71,120,119,46,192,190,8640,829440.0,8449,9120.0
1918,72,55,28,57,251,250,269,268,537,520,518,67519,17554940.0,67000,67340.0
1919,32,26,9,16,119,118,141,140,108,260,258,16779,2181270.0,16520,16770.0
192,68,56,23,41,180,179,313,312,452,493,491,56340,13887810.0,55848,60515.75
1920,50,46,14,20,148,147,179,178,127,327,325,26492,4331442.0,26166,26568.75
1921,81,72,25,41,181,180,283,282,371,464,462,51223,11883736.0,50760,53592.0
1922,52,42,18,36,182,181,153,152,151,335,333,27846,4664205.0,27512,27888.75
1923,47,45,14,16,183,182,99,98,90,282,280,18117,2554497.0,17836,19740.0
1924,37,30,12,22,137,136,121,120,92,258,256,16577,2138433.0,16320,16512.0
1925,99,78,28,64,151,150,255,254,306,406,404,38505,7816515.0,38100,41006.0
1926,77,62,17,45,119,118,161,160,110,280,278,19159,2682260.0,18880,19460.0
1927,55,41,17,43,272,271,158,157,380,430,428,42976,9239840.0,42547,46010.0
1928,159,139,37,73,243,242,291,290,728,534,532,70713,18880371.0,70180,71022.0
1929,98,91,16,28,206,205,170,169,194,376,374,35020,6583760.0,34645,35156.0
193,41,38,15,19,116,115,108,107,60,224,222,12528,1403136.0,12305,12432.0
1930,80,71,21,34,191,190,148,147,160,339,337,28268,4791426.0,27930,28560.75
1931,44,38,15,24,161,160,126,125,101,287,285,20286,2911041.0,20000,20448.75
1932,47,45,7,9,63,62,127,126,38,190,188,8001,760095.0,7812,8930.0
1933,62,46,14,44,152,151,212,211,262,364,362,32224,5864768.0,31861,32942.0
1934,37,34,12,15,77,76,109,108,44,186,184,8393,780549.0,8208,8556.0
1935,23,20,4,6,162,161,99,98,72,261,259,16038,2092959.0,15778,16899.75
1936,62,49,19,42,191,190,304,303,451,495,493,58064,14370840.0,57570,61008.75
1937,60,56,19,25,214,213,128,127,140,342,340,27392,4684032.0,27051,29070.0
1938,50,45,13,17,140,139,104,103,73,244,242,14560,1776320.0,14317,14762.0
1939,48,40,14,28,189,188,126,125,168,315,313,23814,3750705.0,23500,24648.75
194,97,77,31,63,222,221,263,262,500,485,483,58386,14158605.0,57902,58563.75
1940,46,39,13,25,138,137,121,120,67,259,257,16698,2162391.0,16440,16640.75
1941,54,45,19,35,134,133,186,185,135,320,318,24924,3987840.0,24605,25440.0
1942,71,55,22,51,137,136,110,109,94,247,245,15070,1861145.0,14824,15128.75
1943,60,56,15,21,166,165,253,252,303,419,417,41998,8798581.0,41580,43680.75
1944,79,70,19,35,134,133,170,169,125,304,302,22780,3462560.0,22477,22952.0
1945,27,23,7,12,123,122,117,116,62,240,238,14391,1726920.0,14152,14280.0
1946,41,36,13,20,100,99,88,87,39,188,186,8800,827200.0,8613,8742.0
1947,49,40,14,29,108,107,119,118,86,227,225,12852,1458702.0,12626,12768.75
1948,41,35,9,18,165,164,154,153,165,319,317,25410,4052895.0,25092,25280.75
1949,45,38,13,20,238,237,142,141,293,380,378,33796,6421240.0,33417,35910.0
195,23,21,7,9,142,141,232,231,271,374,372,32944,6160528.0,32571,34782.0
1950,38,31,9,17,127,126,104,103,67,231,229,13208,1525524.0,12978,13224.75
1951,37,31,15,24,212,211,159,158,214,371,369,33708,6252834.0,33338,34224.75
1952,45,36,15,30,112,111,143,142,93,255,253,16016,2042040.0,15762,16128.75
1953,145,126,40,76,236,235,309,308,479,545,543,72924,19871790.0,72380,73983.75
1954,41,39,11,13,161,160,90,89,70,251,249,14490,1818495.0,14240,15624.75
1955,50,43,7,17,79,78,84,83,27,163,161,6636,540834.0,6474,6560.75
1956,109,96,33,57,197,196,172,171,294,369,367,33884,6251598.0,33516,33855.75
1957,55,40,19,45,110,109,157,156,86,267,265,17270,2305545.0,17004,17688.75
1958,23,21,6,7,273,272,288,287,545,561,559,78624,22054032.0,78064,78399.75
1959,38,32,14,24,134,133,80,79,52,214,212,10720,1147040.0,10507,11342.0
1960,32,26,11,19,128,127,139,138,87,267,265,17792,2375232.0,17526,17688.75
1962,95,91,23,28,218,217,140,139,179,358,356,30520,5463080.0,30163,31862.0
1963,61,52,22,37,288,287,226,225,464,514,512,65088,16727616.0,64575,65792.0
1964,31,27,10,16,142,141,147,146,131,289,287,20874,3016293.0,20586,20735.75
1965,103,87,23,52,430,429,448,447,12106,878,876,192640,84568960.0,191763,192282.0
1966,163,141,43,85,371,370,247,246,840,618,616,91637,28315833.0,91020,95172.0
1967,171,170,7,7,178,177,178,177,167,356,354,31684,5639752.0,31329,31506.0
1968,62,52,21,37,154,153,217,216,263,371,369,33418,6199039.0,33048,34224.75
1969,69,62,21,33,287,286,390,389,3106,677,675,111930,37888305.0,111254,114243.75
197,90,67,21,65,222,221,176,175,285,398,396,39072,7775328.0,38675,39402.0
1970,67,47,19,54,168,167,163,162,165,331,329,27384,4532052.0,27054,27224.75
1971,53,42,19,37,451,450,215,214,1243,666,664,96965,32289345.0,96300,110556.0
1972,45,35,12,23,135,134,140,139,107,275,273,18900,2598750.0,18626,18768.75
1973,90,74,27,55,194,193,168,167,234,362,360,32592,5899152.0,32231,32580.0
1974,56,46,16,33,147,146,131,130,123,278,276,19257,2676723.0,18980,19182.0
1975,72,64,17,28,156,155,168,167,234,324,322,26208,4245696.0,25885,26082.0
1976,76,69,25,37,143,142,151,150,128,294,292,21593,3174171.0,21300,21462.0
1977,75,52,22,66,264,263,280,279,693,544,542,73920,20106240.0,73377,73712.0
1978,76,68,18,32,131,130,154,153,116,285,283,20174,2874795.0,19890,20163.75
1979,69,56,24,48,469,468,248,247,1122,717,715,116312,41697852.0,115596,128163.75
198,94,77,29,60,301,300,290,289,1230,591,589,87290,25794195.0,86700,87024.75
1980,67,52,19,46,198,197,152,151,229,350,348,30096,5266800.0,29747,30450.0
1981,82,71,25,45,191,190,137,136,156,328,326,26167,4291388.0,25840,26732.0
1982,20,19,6,6,115,114,217,216,167,332,330,24955,4142530.0,24624,27390.0
1983,43,34,14,30,143,142,186,185,202,329,327,26598,4375371.0,26270,26895.75
1984,84,69,24,51,280,279,173,172,263,453,451,48440,10971660.0,47988,51075.75
1985,82,66,25,53,218,217,138,137,221,356,354,30084,5354952.0,29729,31506.0
1986,390,382,13,27,405,404,405,404,3071,810,808,164025,66430125.0,163216,163620.0
1987,51,43,14,28,116,115,129,128,138,245,243,14964,1833090.0,14720,14883.75
1988,50,39,16,36,205,204,175,174,329,380,378,35875,6816250.0,35496,35910.0
1989,39,36,12,16,130,129,120,119,88,250,248,15600,1950000.0,15351,15500.0
199,98,95,15,19,180,179,138,137,136,318,316,24840,3949560.0,24523,25122.0
1990,58,48,20,33,191,190,141,140,165,332,330,26931,4470546.0,26600,27390.0
1991,51,33,14,48,214,213,117,116,160,331,329,25038,4143789.0,24708,27224.75
1992,75,63,22,43,173,172,155,154,239,328,326,26815,4397660.0,26488,26732.0
1993,19,18,5,5,162,161,197,196,165,359,357,31914,5728563.0,31556,32040.75
1994,45,37,15,29,170,169,157,156,139,327,325,26690,4363815.0,26364,26568.75
1995,43,32,11,31,93,92,161,160,123,254,252,14973,1901571.0,14720,16002.0
1996,95,84,30,50,306,305,267,266,653,573,571,81702,23407623.0,81130,81795.75
1998,29,25,7,12,120,119,120,119,73,240,238,14400,1728000.0,14161,14280.0
1999,65,51,25,51,195,194,267,266,511,462,460,52065,12027015.0,51604,53130.0
2,44,34,14,32,118,117,109,108,71,227,225,12862,1459837.0,12636,12768.75
20,60,49,22,42,292,291,376,375,1471,668,666,109792,36670528.0,109125,111222.0
200,73,65,17,31,183,182,130,129,161,313,311,23790,3723135.0,23478,24335.75
2000,52,43,15,31,145,144,124,123,99,269,267,17980,2418310.0,17712,17955.75
2001,58,44,19,43,122,121,137,136,123,259,257,16714,2164463.0,16456,16640.75
2002,76,70,20,30,176,175,143,142,167,319,317,25168,4014296.0,24850,25280.75
2003,59,43,19,49,127,126,180,179,113,307,305,22860,3509010.0,22554,23408.75
2004,67,56,20,39,184,183,144,143,235,328,326,26496,4345344.0,26169,26732.0
2005,65,61,14,18,175,174,275,274,534,450,448,48125,10828125.0,47676,50400.0
2006,65,56,18,34,176,175,222,221,317,398,396,39072,7775328.0,38675,39402.0
2007,78,59,30,65,226,225,229,228,442,455,453,51754,11774035.0,51300,51528.75
2009,60,56,16,22,111,110,168,167,106,279,277,18648,2601396.0,18370,19320.75
201,23,22,5,5,120,119,223,222,183,343,341,26760,4589340.0,26418,29240.75
2010,87,78,24,39,267,266,287,286,708,554,552,76629,21226233.0,76076,76452.0
2011,33,25,10,21,76,75,114,113,36,190,188,8664,823080.0,8475,8930.0
2012,28,25,9,12,115,114,181,180,124,296,294,20815,3080620.0,20520,21756.0
2013,78,67,18,36,150,149,239,238,243,389,387,35850,6972825.0,35462,37635.75
2014,65,52,19,41,190,189,218,217,302,408,406,41420,8449680.0,41013,41412.0
2015,89,58,23,83,244,243,168,167,315,412,410,40992,8444352.0,40581,42230.0
2016,90,66,31,77,244,243,300,299,701,544,542,73200,19910400.0,72657,73712.0
2017,50,42,17,31,145,144,130,129,119,275,273,18850,2591875.0,18576,18768.75
2019,39,27,10,30,138,137,132,131,131,270,268,18216,2459160.0,17947,18090.0
202,38,31,15,27,110,109,250,249,184,360,358,27500,4950000.0,27141,32220.0
2020,84,73,31,49,469,468,385,384,2286,854,852,180565,77101255.0,179712,181902.0
2021,105,85,35,71,262,261,331,330,887,593,591,86722,25713073.0,86130,87615.75
2022,58,51,16,28,118,117,132,131,78,250,248,15576,1947000.0,15327,15500.0
2023,42,36,11,19,140,139,145,144,112,285,283,20300,2892750.0,20016,20163.75
2024,65,60,17,22,115,114,172,171,144,287,285,19780,2838430.0,19494,20448.75
2025,63,54,14,29,209,208,233,232,467,442,440,48697,10762037.0,48256,48620.0
2026,152,128,36,78,299,298,481,480,1969,780,778,143819,56089410.0,143040,151710.0
2028,107,89,38,72,418,417,455,454,2689,873,871,190190,83017935.0,189318,190095.75
2029,61,55,23,32,347,346,167,166,455,514,512,57949,14892893.0,57436,65792.0
203,23,16,3,9,87,86,111,110,56,198,196,9657,956043.0,9460,9702.0
2030,51,42,18,34,170,169,109,108,106,279,277,18530,2584935.0,18252,19320.75
2031,55,47,16,29,129,128,164,163,119,293,291,21156,3099354.0,20864,21315.75
2032,46,39,10,21,90,89,138,137,109,228,226,12420,1415880.0,12193,12882.0
2033,40,37,13,15,171,170,88,87,73,259,257,15048,1948716.0,14790,16640.75
2034,33,31,7,9,114,113,116,115,55,230,228,13224,1520760.0,12995,13110.0
2035,49,40,8,19,120,119,81,80,50,201,199,9720,976860.0,9520,9999.75
2036,63,54,19,35,201,200,237,236,278,438,436,47637,10432503.0,47200,47742.0
2038,257,256,10,10,267,266,267,266,612,534,532,71289,19034163.0,70756,71022.0
2039,43,31,16,38,186,185,98,97,97,284,282,18228,2588376.0,17945,20022.0
204,25,20,6,10,151,150,106,105,85,257,255,16006,2056771.0,15750,16383.75
2040,21,20,6,6,213,212,117,116,162,330,328,24921,4111965.0,24592,27060.0
2041,81,59,26,68,291,290,328,327,762,619,617,95448,29541156.0,94830,95480.75
2042,69,48,23,63,286,285,198,197,439,484,482,56628,13703976.0,56145,58322.0
2044,61,55,19,29,127,126,137,136,84,264,262,17399,2296668.0,17136,17292.0
2045,56,46,21,39,156,155,195,194,217,351,349,30420,5338710.0,30070,30624.75
2046,41,34,13,24,119,118,171,170,130,290,288,20349,2950605.0,20060,20880.0
2047,26,20,10,17,430,429,285,284,1072,715,713,122550,43811625.0,121836,127448.75
2048,48,40,10,24,103,102,90,89,48,193,191,9270,894555.0,9078,9215.75
205,62,52,18,33,90,89,182,181,103,272,270,16380,2227680.0,16109,18360.0
2050,105,101,10,16,178,177,239,238,386,417,415,42542,8870007.0,42126,43263.75
2051,108,93,26,54,167,166,192,191,168,359,357,32064,5755488.0,31706,32040.75
2052,77,66,15,34,223,222,177,176,200,400,398,39471,7894200.0,39072,39800.0
2053,40,35,13,19,144,143,140,139,107,284,282,20160,2862720.0,19877,20022.0
2054,77,68,24,40,192,191,166,165,177,358,356,31872,5705088.0,31515,31862.0
2055,61,52,13,27,104,103,123,122,65,227,225,12792,1451892.0,12566,12768.75
2056,100,89,22,40,232,231,177,176,415,409,407,41064,8397588.0,40656,41615.75
2057,43,37,12,22,129,128,167,166,102,296,294,21543,3188364.0,21248,21756.0
2058,59,49,19,35,159,158,211,210,281,370,368,33549,6206565.0,33180,34040.0
2059,69,54,20,46,245,244,164,163,275,409,407,40180,8216810.0,39772,41615.75
206,69,63,9,17,126,125,107,106,55,233,231,13482,1570653.0,13250,13455.75
2060,38,27,14,33,123,122,273,272,299,396,394,33579,6648642.0,33184,39006.0
2061,52,42,18,33,115,114,107,106,63,222,220,12305,1365855.0,12084,12210.0
2062,117,80,31,102,472,471,373,372,2740,845,843,176056,74383660.0,175212,178083.75
2063,30,28,10,12,249,248,84,83,149,333,331,20916,3482514.0,20584,27555.75
2064,107,102,10,18,124,123,178,177,115,302,300,22072,3332872.0,21771,22650.0
2065,60,43,15,46,115,114,129,128,94,244,242,14835,1809870.0,14592,14762.0
2066,92,73,32,67,293,292,242,241,625,535,533,70906,18967355.0,70372,71288.75
2067,53,44,15,27,122,121,122,121,63,244,242,14884,1815848.0,14641,14762.0
2068,102,81,28,65,259,258,209,208,477,468,466,54131,12666654.0,53664,54522.0
2069,94,77,26,52,204,203,181,180,275,385,383,36924,7107870.0,36540,36863.75
207,48,37,18,38,125,124,271,270,225,396,394,33875,6707250.0,33480,39006.0
2070,85,70,28,54,210,209,180,179,291,390,388,37800,7371000.0,37411,37830.0
2071,43,37,17,26,229,228,152,151,237,381,379,34808,6630924.0,34428,36099.75
2072,52,47,15,23,104,103,119,118,54,223,221,12376,1379924.0,12154,12320.75
2073,77,55,16,56,168,167,139,138,188,307,305,23352,3584532.0,23046,23408.75
2074,73,57,29,56,177,176,212,211,406,389,387,37524,7298418.0,37136,37635.75
2076,32,28,9,14,105,104,111,110,55,216,214,11655,1258740.0,11440,11556.0
2077,62,55,20,32,135,134,134,133,86,269,267,18090,2433105.0,17822,17955.75
2078,69,54,19,47,141,140,270,269,296,411,409,38070,7823385.0,37660,42024.75
2079,112,94,38,72,211,210,300,299,441,511,509,63300,16173150.0,62790,65024.75
208,50,40,19,35,162,161,159,158,149,321,319,25758,4134159.0,25438,25599.75
2080,24,19,8,14,118,117,192,191,154,310,308,22656,3511680.0,22347,23870.0
2082,89,75,30,56,190,189,248,247,278,438,436,47120,10319280.0,46683,47742.0
2083,76,63,31,55,246,245,254,253,462,500,498,62484,15621000.0,61985,62250.0
2084,111,98,33,57,222,221,248,247,364,470,468,55056,12938160.0,54587,54990.0
2085,59,49,17,32,164,163,224,223,379,388,386,36736,7126784.0,36349,37442.0
2086,39,35,14,20,100,99,149,148,64,249,247,14900,1855050.0,14652,15375.75
2087,46,37,17,29,176,175,108,107,111,284,282,19008,2699136.0,18725,20022.0
2088,85,69,23,53,219,218,305,304,467,524,522,66795,17500290.0,66272,68382.0
2089,352,338,20,46,377,376,405,404,2418,782,780,152685,59699835.0,151904,152490.0
209,33,27,7,13,161,160,154,153,135,315,313,24794,3905055.0,24480,24648.75
2090,53,41,19,37,150,149,184,183,181,334,332,27600,4609200.0,27267,27722.0
2091,97,76,32,72,279,278,336,335,1017,615,613,93744,28826280.0,93130,94248.75
2092,86,81,7,12,166,165,143,142,159,309,307,23738,3667521.0,23430,23715.75
2093,53,46,17,29,320,319,300,299,1231,620,618,96000,29760000.0,95381,95790.0
2094,115,102,27,45,260,259,179,178,331,439,437,46540,10215530.0,46102,47960.75
2095,72,66,25,35,192,191,191,190,233,383,381,36672,7022688.0,36290,36480.75
2096,45,34,14,34,321,320,193,192,582,514,512,61953,15921921.0,61440,65792.0
2097,32,28,11,15,143,142,113,112,78,256,254,16159,2068352.0,15904,16256.0
2098,78,68,26,42,183,182,210,209,314,393,391,38430,7551495.0,38038,38415.75
2099,94,86,23,37,213,212,182,181,267,395,393,38766,7656285.0,38372,38808.75
21,53,45,14,26,93,92,122,121,64,215,213,11346,1219695.0,11132,11448.75
210,39,36,14,18,223,222,126,125,197,349,347,28098,4903101.0,27750,30275.75
2100,50,47,13,15,181,180,120,119,151,301,299,21720,3268860.0,21420,22499.75
2101,44,32,11,31,130,129,133,132,118,263,261,17290,2273635.0,17028,17160.75
2102,67,52,25,52,195,194,117,116,144,312,310,22815,3559140.0,22504,24180.0
2103,46,27,12,45,136,135,131,130,106,267,265,17816,2378436.0,17550,17688.75
2104,33,30,7,10,188,187,140,139,165,328,326,26320,4316480.0,25993,26732.0
2105,79,65,28,51,355,354,223,222,596,578,576,79165,22878685.0,78588,83232.0
2106,86,80,18,28,146,145,196,195,143,342,340,28616,4893336.0,28275,29070.0
2107,57,49,16,29,130,129,101,100,58,231,229,13130,1516515.0,12900,13224.75
2108,61,51,21,39,261,260,199,198,478,460,458,51939,11945970.0,51480,52670.0
2109,128,98,38,92,245,244,273,272,532,518,516,66885,17323215.0,66368,66822.0
211,64,51,22,45,162,161,130,129,133,292,290,21060,3074760.0,20769,21170.0
2110,24,21,10,14,186,185,130,129,165,316,314,24180,3820440.0,23865,24806.0
2111,76,67,23,39,160,159,179,178,172,339,337,28640,4854480.0,28302,28560.75
2112,50,42,17,30,227,226,129,128,164,356,354,29283,5212374.0,28928,31506.0
2113,53,47,15,25,243,242,124,123,167,367,365,30132,5529222.0,29766,33488.75
2114,61,52,17,32,186,185,102,101,160,288,286,18972,2731968.0,18685,20592.0
2115,391,383,13,27,405,404,405,404,3001,810,808,164025,66430125.0,163216,163620.0
2116,45,37,16,25,214,213,109,108,148,323,321,23326,3767149.0,23004,25920.75
2117,75,64,17,35,275,274,189,188,406,464,462,51975,12058200.0,51512,53592.0
2118,70,67,12,15,158,157,161,160,139,319,317,25438,4057361.0,25120,25280.75
212,101,94,20,29,237,236,180,179,302,417,415,42660,8894610.0,42244,43263.75
2120,53,39,12,37,189,188,135,134,180,324,322,25515,4133430.0,25192,26082.0
2121,125,105,40,77,359,358,526,525,2534,885,883,188834,83559045.0,187950,195363.75
2122,52,47,13,20,115,114,120,119,63,235,233,13800,1621500.0,13566,13688.75
2123,94,84,24,39,289,288,175,174,503,464,462,50575,11733400.0,50112,53592.0
2124,88,81,19,31,178,177,210,209,216,388,386,37380,7251720.0,36993,37442.0
2125,78,64,21,44,217,216,119,118,185,336,334,25823,4338264.0,25488,28056.0
2126,57,48,19,31,182,181,140,139,184,322,320,25480,4102280.0,25159,25760.0
2127,35,32,11,15,151,150,79,78,62,230,228,11929,1371835.0,11700,13110.0
2128,63,50,14,38,116,115,182,181,161,298,296,21112,3145688.0,20815,22052.0
2129,105,101,10,16,124,123,178,177,116,302,300,22072,3332872.0,21771,22650.0
213,83,70,23,47,248,247,183,182,287,431,429,45384,9780252.0,44954,46224.75
2130,35,30,9,16,87,86,202,201,99,289,287,17574,2539443.0,17286,20735.75
2131,86,73,20,44,207,206,224,223,729,431,429,46368,9992304.0,45938,46224.75
2132,36,29,10,20,98,97,111,110,50,209,207,10878,1136751.0,10670,10815.75
2133,390,382,13,27,405,404,405,404,3065,810,808,164025,66430125.0,163216,163620.0
2134,54,45,21,36,134,133,259,258,213,393,391,34706,6819729.0,34314,38415.75
2135,63,53,20,38,155,154,125,124,133,280,278,19375,2712500.0,19096,19460.0
2136,70,53,21,52,461,460,231,230,1356,692,690,106491,36845886.0,105800,119370.0
2137,76,61,24,51,144,143,238,237,282,382,380,34272,6545952.0,33891,36290.0
2138,69,62,24,36,359,358,186,185,479,545,543,66774,18195915.0,66230,73983.75
2139,66,58,23,36,220,219,179,178,260,399,397,39380,7856310.0,38982,39600.75
214,53,46,17,29,262,261,109,108,192,371,369,28558,5297509.0,28188,34224.75
2140,62,51,19,38,143,142,113,112,92,256,254,16159,2068352.0,15904,16256.0
2141,28,23,9,15,70,69,152,151,56,222,220,10640,1181040.0,10419,12210.0
2142,33,29,9,15,144,143,120,119,98,264,262,17280,2280960.0,17017,17292.0
2143,48,43,12,20,92,91,166,165,73,258,256,15272,1970088.0,15015,16512.0
2144,78,67,21,41,137,136,242,241,221,379,377,33154,6282683.0,32776,35720.75
2145,64,56,13,27,127,126,134,133,173,261,259,17018,2220849.0,16758,16899.75
2146,17,15,5,7,154,153,141,140,161,295,293,21714,3202815.0,21420,21608.75
2147,40,29,8,27,168,167,107,106,143,275,273,17976,2471700.0,17702,18768.75
2148,100,78,29,69,299,298,265,264,942,564,562,79235,22344270.0,78672,79242.0
2149,63,53,14,31,102,101,148,147,128,250,248,15096,1887000.0,14847,15500.0
215,93,86,23,35,148,147,160,159,128,308,306,23680,3646720.0,23373,23562.0
2150,46,43,13,16,108,107,106,105,79,214,212,11448,1224936.0,11235,11342.0
2151,69,60,22,37,136,135,242,241,197,378,376,32912,6220368.0,32535,35532.0
2152,39,32,16,24,186,185,238,237,255,424,422,44268,9384816.0,43845,44732.0
2153,46,35,11,24,96,95,115,114,59,211,209,11040,1164720.0,10830,11024.75
2154,65,46,11,45,188,187,141,140,197,329,327,26508,4360566.0,26180,26895.75
2155,96,84,22,44,175,174,147,146,130,322,320,25725,4141725.0,25404,25760.0
2156,24,19,10,16,136,135,204,203,174,340,338,27744,4716480.0,27405,28730.0
2158,72,65,29,40,286,285,215,214,519,501,499,61490,15403245.0,60990,62499.75
2159,97,73,24,68,188,187,258,257,370,446,444,48504,10816392.0,48059,49506.0
216,90,72,23,51,171,170,188,187,194,359,357,32148,5770566.0,31790,32040.75
2160,93,77,31,61,327,326,287,286,1293,614,612,93849,28811643.0,93236,93942.0
2162,45,41,13,17,151,150,221,220,203,372,370,33371,6207006.0,33000,34410.0
2163,42,34,12,26,120,119,160,159,107,280,278,19200,2688000.0,18921,19460.0
2164,52,38,16,41,204,203,173,172,185,377,375,35292,6652542.0,34916,35343.75
2165,63,57,15,25,168,167,103,102,116,271,269,17304,2344692.0,17034,18224.75
2166,39,32,10,17,133,132,136,135,92,269,267,18088,2432836.0,17820,17955.75
2167,31,19,5,17,193,192,114,113,137,307,305,22002,3377307.0,21696,23408.75
2168,61,50,22,38,295,294,193,192,470,488,486,56935,13892140.0,56448,59292.0
2169,43,38,10,17,330,329,446,445,2442,776,774,147180,57105840.0,146405,150156.0
217,33,25,10,22,119,118,94,93,52,213,211,11186,1191309.0,10974,11235.75
2170,48,43,13,21,149,148,185,184,179,334,332,27565,4603355.0,27232,27722.0
2172,55,49,18,26,126,125,152,151,135,278,276,19152,2662128.0,18875,19182.0
2173,23,18,8,12,125,124,91,90,62,216,214,11375,1228500.0,11160,11556.0
2174,92,70,29,68,202,201,471,470,899,673,671,95142,32015283.0,94470,112895.75
2175,77,76,10,10,98,97,100,99,55,198,196,9800,970200.0,9603,9702.0
2176,58,49,14,28,118,117,135,134,76,253,251,15930,2015145.0,15678,15875.75
2177,166,132,62,127,427,426,509,508,4638,936,934,217343,101716524.0,216408,218556.0
2178,58,46,22,44,288,287,380,379,1449,668,666,109440,36552960.0,108773,111222.0
2179,49,36,16,30,168,167,187,186,291,355,353,31416,5576340.0,31062,31328.75
218,79,69,26,44,164,163,272,271,313,436,434,44608,9724544.0,44173,47306.0
2180,108,92,30,59,296,295,214,213,503,510,508,63344,16152720.0,62835,64770.0
2181,101,77,32,77,254,253,267,266,721,521,519,67818,17666589.0,67298,67599.75
2182,48,42,18,25,136,135,125,124,95,261,259,17000,2218500.0,16740,16899.75
2183,69,60,21,36,226,225,133,132,165,359,357,30058,5395411.0,29700,32040.75
2184,22,21,7,7,198,197,165,164,181,363,361,32670,5929605.0,32308,32760.75
2185,40,35,8,14,218,217,91,90,125,309,307,19838,3064971.0,19530,23715.75
2186,140,107,43,106,360,359,352,351,1278,712,710,126720,45112320.0,126009,126380.0
2187,76,61,21,49,150,149,138,137,127,288,286,20700,2980800.0,20413,20592.0
2188,72,57,26,52,261,260,200,199,356,461,459,52200,12032100.0,51740,52899.75
2189,77,64,31,54,196,195,258,257,646,454,452,50568,11478936.0,50115,51302.0
219,67,45,12,54,235,234,316,315,652,551,549,74260,20458630.0,73710,75624.75
2190,28,24,6,9,98,97,94,93,35,192,190,9212,884352.0,9021,9120.0
2191,112,96,34,64,329,328,223,222,529,552,550,73367,20249292.0,72816,75900.0
2192,76,68,12,26,155,154,122,121,89,277,275,18910,2619035.0,18634,19043.75
2193,51,39,17,38,125,124,169,168,132,294,292,21125,3105375.0,20832,21462.0
2194,65,57,21,35,318,317,215,214,649,533,531,68370,18220605.0,67838,70755.75
2195,153,102,48,146,471,470,321,320,2061,792,790,151191,59871636.0,150400,156420.0
2196,54,44,24,42,150,149,187,186,151,337,335,28050,4726425.0,27714,28223.75
2197,59,54,18,24,93,92,119,118,50,212,210,11067,1173102.0,10856,11130.0
2198,50,37,16,35,110,109,206,205,160,316,314,22660,3580280.0,22345,24806.0
2199,135,134,7,7,170,169,216,215,234,386,384,36720,7086960.0,36335,37056.0
22,35,30,8,13,210,209,434,433,4439,644,642,91140,29347080.0,90497,103362.0
220,56,47,21,37,138,137,188,187,138,326,324,25944,4228872.0,25619,26406.0
2200,58,45,15,39,119,118,137,136,100,256,254,16303,2086784.0,16048,16256.0
2201,77,73,15,21,154,153,112,111,156,266,264,17248,2293984.0,16983,17556.0
2202,35,29,11,18,149,148,108,107,65,257,255,16092,2067822.0,15836,16383.75
2203,44,39,11,17,108,107,154,153,93,262,260,16632,2178792.0,16371,17030.0
2204,42,39,10,14,175,174,172,171,181,347,345,30100,5222350.0,29754,29928.75
2205,57,51,8,15,159,158,131,130,100,290,288,20829,3020205.0,20540,20880.0
2206,60,55,19,27,178,177,195,194,330,373,371,34710,6473415.0,34338,34595.75
2207,39,32,12,24,207,206,126,125,143,333,331,26082,4342653.0,25750,27555.75
2208,52,45,12,20,128,127,90,89,59,218,216,11520,1255680.0,11303,11772.0
2209,49,41,16,30,200,199,238,237,309,438,436,47600,10424400.0,47163,47742.0
221,83,74,22,36,162,161,239,238,276,401,399,38718,7762959.0,38318,39999.75
2210,51,45,13,21,130,129,167,166,140,297,295,21710,3223935.0,21414,21903.75
2211,68,54,25,51,134,133,161,160,149,295,293,21574,3182165.0,21280,21608.75
2212,60,56,18,24,117,116,135,134,80,252,250,15795,1990170.0,15544,15750.0
2213,54,45,13,29,111,110,138,137,88,249,247,15318,1907091.0,15070,15375.75
2214,71,59,20,42,377,376,167,166,462,544,542,62959,17124848.0,62416,73712.0
2215,57,52,13,20,120,119,118,117,67,238,236,14160,1685040.0,13923,14042.0
2216,43,38,15,23,154,153,164,163,188,318,316,25256,4015704.0,24939,25122.0
2217,72,58,22,48,143,142,150,149,125,293,291,21450,3142425.0,21158,21315.75
2218,66,48,23,53,222,221,146,145,201,368,366,32412,5963808.0,32045,33672.0
2219,74,58,22,52,152,151,167,166,162,319,317,25384,4048748.0,25066,25280.75
222,40,34,9,19,89,88,106,105,37,195,193,9434,919815.0,9240,9408.75
2220,54,47,19,28,158,157,209,208,203,367,365,33022,6059537.0,32656,33488.75
2221,107,87,32,70,397,396,313,312,1360,710,708,124261,44112655.0,123552,125670.0
2222,21,19,5,6,119,118,220,219,172,339,337,26180,4437510.0,25842,28560.75
2223,93,81,24,46,481,480,368,367,4309,849,847,177008,75139896.0,176160,179775.75
2224,98,81,29,60,224,223,179,178,300,403,401,40096,8079344.0,39694,40400.75
2225,59,50,23,37,249,248,147,146,192,396,394,36603,7247394.0,36208,39006.0
2227,37,30,10,22,130,129,93,92,67,223,221,12090,1348035.0,11868,12320.75
2228,87,77,18,35,186,185,233,232,347,419,417,43338,9079311.0,42920,43680.75
2229,35,32,8,12,93,92,354,353,250,447,445,32922,7358067.0,32476,49728.75
223,91,78,25,47,285,284,292,291,497,577,575,83220,24008970.0,82644,82943.75
2230,391,383,13,27,405,404,405,404,3065,810,808,164025,66430125.0,163216,163620.0
2231,140,139,7,7,147,146,147,146,111,294,292,21609,3176523.0,21316,21462.0
2232,23,17,5,13,99,98,126,125,87,225,223,12474,1403325.0,12250,12543.75
2233,37,28,11,27,204,203,123,122,151,327,325,25092,4102542.0,24766,26568.75
2234,49,43,18,28,108,107,242,241,170,350,348,26136,4573800.0,25787,30450.0
2235,82,59,27,71,223,222,276,275,685,499,497,61548,15356226.0,61050,62000.75
2236,46,34,11,32,135,134,223,222,217,358,356,30105,5388795.0,29748,31862.0
2237,87,78,26,42,217,216,162,161,262,379,377,35154,6661683.0,34776,35720.75
2239,37,30,14,25,83,82,128,127,64,211,209,10624,1120832.0,10414,11024.75
224,51,43,15,29,110,109,160,159,144,270,268,17600,2376000.0,17331,18090.0
2241,50,42,16,29,140,139,114,113,86,254,252,15960,2026920.0,15707,16002.0
2243,55,49,15,25,195,194,193,192,271,388,386,37635,7301190.0,37248,37442.0
2244,56,44,17,39,166,165,115,114,91,281,279,19090,2682145.0,18810,19599.75
2245,180,129,57,156,450,449,402,401,4064,852,850,180900,77063400.0,180049,181050.0
2247,106,94,23,43,203,202,177,176,259,380,378,35931,6826890.0,35552,35910.0
2248,27,24,10,14,198,197,86,85,104,284,282,17028,2417976.0,16745,20022.0
2249,81,70,24,44,184,183,138,137,147,322,320,25392,4088112.0,25071,25760.0
225,95,80,23,51,194,193,141,140,266,335,333,27354,4581795.0,27020,27888.75
2250,62,48,25,48,131,130,193,192,195,324,322,25283,4095846.0,24960,26082.0
2251,252,213,68,144,486,485,497,496,4503,983,981,241542,118717893.0,240560,241080.75
2252,41,36,14,20,101,100,111,110,53,212,210,11211,1188366.0,11000,11130.0
2253,42,35,9,20,100,99,157,156,117,257,255,15700,2017450.0,15444,16383.75
2254,40,35,10,14,261,260,163,162,364,424,422,42543,9019116.0,42120,44732.0
2255,61,53,15,29,75,74,123,122,38,198,196,9225,913275.0,9028,9702.0
2256,114,100,34,58,253,252,207,206,380,460,458,52371,12045330.0,51912,52670.0
2257,37,33,13,19,147,146,109,108,88,256,254,16023,2050944.0,15768,16256.0
2258,57,48,16,32,126,125,104,103,77,230,228,13104,1506960.0,12875,13110.0
2259,56,45,18,37,236,235,113,112,186,349,347,26668,4653566.0,26320,30275.75
226,76,47,23,77,161,160,304,303,358,465,463,48944,11379480.0,48480,53823.75
2260,64,55,24,35,212,211,367,366,684,579,577,77804,22524258.0,77226,83520.75
2261,31,24,6,15,178,177,140,139,166,318,316,24920,3962280.0,24603,25122.0
2262,85,73,30,52,151,150,261,260,295,412,410,39411,8118666.0,39000,42230.0
2263,91,81,23,41,383,382,166,165,513,549,547,63578,17452161.0,63030,75075.75
2264,67,52,23,50,425,424,206,205,802,631,629,87550,27622025.0,86920,99224.75
2265,78,69,26,42,286,285,165,164,334,451,449,47190,10641345.0,46740,50624.75
2266,164,158,17,27,235,234,238,237,560,473,471,55930,13227445.0,55458,55695.75
2267,83,72,23,43,171,170,138,137,170,309,307,23598,3645891.0,23290,23715.75
2268,52,41,19,37,193,192,152,151,201,345,343,29336,5060460.0,28992,29583.75
2269,41,35,13,21,118,117,95,94,51,213,211,11210,1193865.0,10998,11235.75
227,54,46,16,29,100,99,232,231,221,332,330,23200,3851200.0,22869,27390.0
2270,103,94,30,46,144,143,208,207,218,352,350,29952,5271552.0,29601,30800.0
2271,55,50,12,20,107,106,74,73,51,181,179,7918,716579.0,7738,8099.75
2272,47,38,19,35,171,170,427,426,793,598,596,73017,21832083.0,72420,89102.0
2273,75,59,22,52,265,264,173,172,351,438,436,45845,10040055.0,45408,47742.0
2274,122,117,13,21,147,146,178,177,190,325,323,26166,4251975.0,25842,26243.75
2275,97,82,19,47,393,392,205,204,656,598,596,80565,24088935.0,79968,89102.0
2276,58,46,16,36,282,281,215,214,698,497,495,60630,15066555.0,60134,61503.75
2277,110,84,22,72,266,265,250,249,556,516,514,66500,17157000.0,65985,66306.0
2278,70,57,16,38,123,122,116,115,88,239,237,14268,1705026.0,14030,14160.75
2279,95,76,17,52,223,222,178,177,411,401,399,39694,7958647.0,39294,39999.75
228,41,35,16,26,117,116,136,135,95,253,251,15912,2012868.0,15660,15875.75
2280,38,33,10,18,95,94,154,153,66,249,247,14630,1821435.0,14382,15375.75
2282,44,34,13,29,101,100,138,137,93,239,237,13938,1665591.0,13700,14160.75
2283,107,86,31,71,343,342,549,548,4001,892,890,188307,83984922.0,187416,198470.0
2284,60,49,14,33,115,114,111,110,68,226,224,12765,1442445.0,12540,12656.0
2285,71,64,19,29,153,152,228,227,191,381,379,34884,6645402.0,34504,36099.75
2286,61,51,11,24,157,156,99,98,91,256,254,15543,1989504.0,15288,16256.0
2287,70,63,20,32,166,165,155,154,194,321,319,25730,4129665.0,25410,25599.75
2288,45,38,16,26,253,252,281,280,667,534,532,71093,18981831.0,70560,71022.0
2289,32,26,11,19,88,87,91,90,40,179,177,8008,716716.0,7830,7920.75
229,54,33,11,49,159,158,174,173,175,333,331,27666,4606389.0,27334,27555.75
2290,91,75,26,54,164,163,271,270,356,435,433,44444,9666570.0,44010,47088.75
2291,24,21,4,6,110,109,145,144,91,255,253,15950,2033625.0,15696,16128.75
2292,36,34,11,13,124,123,110,109,64,234,232,13640,1595880.0,13407,13572.0
2293,115,97,39,73,232,231,210,209,576,442,440,48720,10767120.0,48279,48620.0
2294,70,54,16,46,117,116,116,115,91,233,231,13572,1581138.0,13340,13455.75
2295,49,41,16,30,141,140,271,270,292,412,410,38211,7871466.0,37800,42230.0
2296,83,72,26,45,273,272,293,292,609,566,564,79989,22636887.0,79424,79806.0
2297,49,38,12,24,112,111,158,157,133,270,268,17696,2388960.0,17427,18090.0
2298,126,101,44,92,289,288,358,357,1299,647,645,103462,33469957.0,102816,104328.75
2299,42,30,15,36,144,143,119,118,124,263,261,17136,2253384.0,16874,17160.75
23,41,38,10,14,101,100,117,116,59,218,216,11817,1288053.0,11600,11772.0
230,49,41,12,24,99,98,127,126,60,226,224,12573,1420749.0,12348,12656.0
2300,89,68,29,69,236,235,235,234,419,471,469,55460,13060830.0,54990,55224.75
2301,60,53,20,31,244,243,212,211,570,456,454,51728,11793984.0,51273,51756.0
2302,47,38,16,31,141,140,115,114,87,256,254,16215,2075520.0,15960,16256.0
2304,47,39,15,28,122,121,128,127,154,250,248,15616,1952000.0,15367,15500.0
2305,44,39,14,20,156,155,105,104,82,261,259,16380,2137590.0,16120,16899.75
2306,71,61,19,37,236,235,371,370,672,607,605,87556,26573246.0,86950,91808.75
2307,158,125,63,126,484,483,444,443,2322,928,926,214896,99711744.0,213969,214832.0
2308,72,57,24,52,544,543,238,237,1307,782,780,129472,50623552.0,128691,152490.0
2309,69,58,23,43,162,161,279,278,350,441,439,45198,9966159.0,44758,48399.75
231,87,71,27,55,163,162,197,196,335,360,358,32111,5779980.0,31752,32220.0
2310,180,152,47,101,398,397,401,400,2365,799,797,159598,63759401.0,158800,159200.75
2311,69,54,18,44,195,194,121,120,127,316,314,23595,3728010.0,23280,24806.0
2312,83,73,30,48,138,137,165,164,144,303,301,22770,3449655.0,22468,22800.75
2313,141,117,50,96,465,464,450,449,3514,915,913,209250,95731875.0,208336,208848.75
2314,91,77,30,55,383,382,482,481,2816,865,863,184606,79842095.0,183742,186623.75
2315,34,29,11,19,208,207,135,134,165,343,341,28080,4815720.0,27738,29240.75
2316,49,41,15,26,234,233,139,138,330,373,371,32526,6066099.0,32154,34595.75
2317,105,101,10,16,124,123,178,177,116,302,300,22072,3332872.0,21771,22650.0
2318,58,48,16,29,108,107,181,180,195,289,287,19548,2824686.0,19260,20735.75
2319,51,47,15,21,104,103,153,152,91,257,255,15912,2044692.0,15656,16383.75
232,63,50,23,45,178,177,160,159,179,338,336,28480,4813120.0,28143,28392.0
2320,48,42,16,25,119,118,128,127,87,247,245,15232,1881152.0,14986,15128.75
2321,63,50,16,37,181,180,245,244,317,426,424,44345,9445485.0,43920,45156.0
2322,79,67,17,39,120,119,146,145,101,266,264,17520,2330160.0,17255,17556.0
2323,31,29,9,11,153,152,93,92,82,246,244,14229,1750167.0,13984,15006.0
2324,49,45,11,17,121,120,128,127,78,249,247,15488,1928256.0,15240,15375.75
2325,62,54,17,31,121,120,145,144,102,266,264,17545,2333485.0,17280,17556.0
2326,98,83,24,51,143,142,205,204,182,348,346,29315,5100810.0,28968,30102.0
2327,108,104,7,13,124,123,178,177,122,302,300,22072,3332872.0,21771,22650.0
2328,68,57,23,43,371,370,217,216,544,588,586,80507,23669058.0,79920,86142.0
2329,68,53,16,44,174,173,132,131,233,306,304,22968,3514104.0,22663,23256.0
233,52,42,18,33,118,117,133,132,93,251,249,15694,1969597.0,15444,15624.75
2330,59,50,19,34,167,166,145,144,127,312,310,24215,3777540.0,23904,24180.0
2331,28,17,7,23,123,122,158,157,129,281,279,19434,2730477.0,19154,19599.75
2332,141,139,9,11,193,192,147,146,169,340,338,28371,4823070.0,28032,28730.0
2333,42,31,11,31,131,130,163,162,132,294,292,21353,3138891.0,21060,21462.0
2334,67,59,16,25,157,156,120,119,129,277,275,18840,2609340.0,18564,19043.75
2335,62,48,16,40,257,256,132,131,288,389,387,33924,6598218.0,33536,37635.75
2336,22,21,5,5,203,202,164,163,178,367,365,33292,6109082.0,32926,33488.75
2337,51,40,13,33,93,92,142,141,84,235,233,13206,1551705.0,12972,13688.75
2338,63,58,21,29,240,239,183,182,291,423,421,43920,9289080.0,43498,44520.75
2339,39,30,10,26,166,165,110,109,108,276,274,18260,2519880.0,17985,18906.0
234,108,103,11,19,178,177,262,261,477,440,438,46636,10259920.0,46197,48180.0
2340,48,42,20,30,148,147,121,120,88,269,267,17908,2408626.0,17640,17955.75
2341,61,53,22,36,186,185,290,289,331,476,474,53940,12837720.0,53465,56406.0
2342,63,50,24,48,232,231,155,154,277,387,385,35960,6958260.0,35574,37248.75
2343,257,256,10,10,267,266,267,266,597,534,532,71289,19034163.0,70756,71022.0
2344,118,117,7,7,147,146,262,261,296,409,407,38514,7876113.0,38106,41615.75
2345,63,50,17,41,105,104,163,162,105,268,266,17115,2293410.0,16848,17822.0
2346,110,90,34,71,217,216,307,306,748,524,522,66619,17454178.0,66096,68382.0
2347,41,34,12,23,101,100,144,143,95,245,243,14544,1781640.0,14300,14883.75
2348,47,37,14,32,107,106,146,145,72,253,251,15622,1976183.0,15370,15875.75
2349,42,32,6,16,167,166,153,152,190,320,318,25551,4088160.0,25232,25440.0
235,60,50,19,37,275,274,153,152,365,428,426,42075,9004050.0,41648,45582.0
2350,75,64,20,39,135,134,229,228,227,364,362,30915,5626530.0,30552,32942.0
2351,44,36,15,29,96,95,157,156,77,253,251,15072,1906608.0,14820,15875.75
2352,111,86,30,67,256,255,384,383,885,640,638,98304,31457280.0,97665,102080.0
2353,41,33,10,21,121,120,84,83,35,205,203,10164,1041810.0,9960,10403.75
2354,77,67,19,36,128,127,226,225,232,354,352,28928,5120256.0,28575,31152.0
2355,38,30,10,24,94,93,98,97,70,192,190,9212,884352.0,9021,9120.0
2356,32,30,7,8,95,94,85,84,33,180,178,8075,726750.0,7896,8010.0
2357,58,47,18,37,114,113,219,218,204,333,331,24966,4156839.0,24634,27555.75
2359,78,59,21,54,158,157,157,156,167,315,313,24806,3906945.0,24492,24648.75
236,27,25,8,9,151,150,156,155,152,307,305,23556,3615846.0,23250,23408.75
2360,25,23,6,8,153,152,144,143,104,297,295,22032,3271752.0,21736,21903.75
2361,77,63,21,47,178,177,147,146,143,325,323,26166,4251975.0,25842,26243.75
2362,33,28,9,15,102,101,111,110,51,213,211,11322,1205793.0,11110,11235.75
2363,38,35,13,16,214,213,97,96,98,311,309,20758,3227869.0,20448,24024.75
2364,36,28,12,26,288,287,206,205,627,494,492,59328,14654016.0,58835,60762.0
2365,132,118,25,51,288,287,248,247,696,536,534,71424,19141632.0,70889,71556.0
2366,123,89,27,88,212,211,290,289,642,502,500,61480,15431480.0,60979,62750.0
2367,61,55,16,26,94,93,173,172,94,267,265,16262,2170977.0,15996,17688.75
2368,88,80,25,39,128,127,192,191,146,320,318,24576,3932160.0,24257,25440.0
2369,37,32,10,16,257,256,383,382,1418,640,638,98431,31497920.0,97792,102080.0
237,23,22,8,8,194,193,189,188,194,383,381,36666,7021539.0,36284,36480.75
2370,47,41,13,23,107,106,151,150,79,258,256,16157,2084253.0,15900,16512.0
2371,94,77,24,53,179,178,299,298,488,478,476,53521,12791519.0,53044,56882.0
2372,53,43,16,34,107,106,103,102,64,210,208,11021,1157205.0,10812,10920.0
2373,90,67,27,71,166,165,212,211,453,378,376,35192,6651288.0,34815,35532.0
2374,105,81,34,80,347,346,412,411,1475,759,757,142964,54254838.0,142206,143640.75
2375,45,35,17,31,328,327,341,340,834,669,667,111848,37413156.0,111180,111555.75
2376,58,45,14,36,151,150,120,119,97,271,269,18120,2455260.0,17850,18224.75
2377,90,73,30,62,239,238,338,337,534,577,575,80782,23305607.0,80206,82943.75
2378,58,41,14,40,144,143,157,156,131,301,299,22608,3402504.0,22308,22499.75
2379,105,82,40,81,320,319,231,230,613,551,549,73920,20364960.0,73370,75624.75
238,79,64,20,48,148,147,174,173,176,322,320,25752,4146072.0,25431,25760.0
2380,58,42,17,45,159,158,190,189,246,349,347,30210,5271645.0,29862,30275.75
2381,41,30,11,26,143,142,106,105,88,249,247,15158,1887171.0,14910,15375.75
2382,49,43,18,28,237,236,107,106,151,344,342,25359,4361748.0,25016,29412.0
2383,60,45,18,45,186,185,122,121,149,308,306,22692,3494568.0,22385,23562.0
2384,54,44,15,31,112,111,134,133,81,246,244,15008,1845984.0,14763,15006.0
2385,27,23,6,10,214,213,109,108,126,323,321,23326,3767149.0,23004,25920.75
2386,60,54,14,24,96,95,151,150,98,247,245,14496,1790256.0,14250,15128.75
2387,61,54,19,31,122,121,158,157,126,280,278,19276,2698640.0,18997,19460.0
2388,34,26,12,24,96,95,105,104,45,201,199,10080,1013040.0,9880,9999.75
2389,43,41,13,15,133,132,174,173,130,307,305,23142,3552297.0,22836,23408.75
239,103,88,32,60,318,317,234,233,737,552,550,74412,20537712.0,73861,75900.0
2390,120,101,44,79,262,261,442,441,1074,704,702,115804,40763008.0,115101,123552.0
2391,69,58,23,43,250,249,132,131,241,382,380,33000,6303000.0,32619,36290.0
2392,155,154,8,8,170,169,170,169,175,340,338,28900,4913000.0,28561,28730.0
2393,66,61,22,30,137,136,132,131,122,269,267,18084,2432298.0,17816,17955.75
2394,66,53,21,43,235,234,248,247,458,483,481,58280,14074620.0,57798,58080.75
2395,74,59,23,50,216,215,171,170,256,387,385,36936,7147116.0,36550,37248.75
2396,116,93,41,84,503,502,448,447,3852,951,949,225344,107151072.0,224394,225624.75
2397,176,141,58,126,371,370,360,359,1713,731,729,133560,48816180.0,132830,133224.75
2398,22,21,7,7,137,136,127,126,90,264,262,17399,2296668.0,17136,17292.0
2399,52,46,18,28,225,224,253,252,393,478,476,56925,13605075.0,56448,56882.0
24,42,27,8,35,123,122,199,198,167,322,320,24477,3940797.0,24156,25760.0
240,39,32,12,19,88,87,161,160,83,249,247,14168,1763916.0,13920,15375.75
2400,19,18,5,5,185,184,102,101,117,287,285,18870,2707845.0,18584,20448.75
2401,75,59,18,48,141,140,198,197,183,339,337,27918,4732101.0,27580,28560.75
2402,87,74,26,49,257,256,245,244,563,502,500,62965,15804215.0,62464,62750.0
2403,113,83,32,89,321,320,308,307,1166,629,627,98868,31093986.0,98240,98595.75
2405,50,43,18,30,398,397,134,133,381,532,530,53332,14186312.0,52801,70490.0
2406,103,78,31,78,328,327,230,229,599,558,556,75440,21047760.0,74883,77562.0
2407,98,97,4,4,170,169,147,146,129,317,315,24990,3960915.0,24674,24963.75
2408,62,52,22,40,173,172,223,222,249,396,394,38579,7638642.0,38184,39006.0
2409,71,60,23,43,147,146,248,247,304,395,393,36456,7200060.0,36062,38808.75
241,40,37,13,17,143,142,165,164,127,308,306,23595,3633630.0,23288,23562.0
2410,37,30,10,21,138,137,95,94,65,233,231,13110,1527315.0,12878,13455.75
2411,38,28,12,30,132,131,83,82,54,215,213,10956,1177770.0,10742,11448.75
2412,167,142,67,114,270,269,429,428,1648,699,697,115830,40482585.0,115132,121800.75
2413,115,94,42,82,225,224,342,341,560,567,565,76950,21815325.0,76384,80088.75
2414,48,37,14,28,115,114,246,245,195,361,359,28290,5106345.0,27930,32399.75
2415,49,46,17,21,137,136,172,171,171,309,307,23564,3640638.0,23256,23715.75
2416,91,76,27,50,203,202,163,162,250,366,364,33089,6055287.0,32724,33306.0
2417,85,66,22,57,324,323,265,264,807,589,587,85860,25285770.0,85272,86435.75
2418,47,38,18,34,136,135,216,215,208,352,350,29376,5170176.0,29025,30800.0
2419,74,58,22,51,151,150,182,181,236,333,331,27482,4575753.0,27150,27555.75
242,79,69,23,41,193,192,268,267,332,461,459,51724,11922382.0,51264,52899.75
2420,97,89,29,42,260,259,307,306,701,567,565,79820,22628970.0,79254,80088.75
2421,37,29,11,22,214,213,263,262,479,477,475,56282,13423257.0,55806,56643.75
2422,61,51,18,34,101,100,141,140,75,242,240,14241,1723161.0,14000,14520.0
2423,27,24,8,12,175,174,155,154,179,330,328,27125,4475625.0,26796,27060.0
2424,118,97,37,76,270,269,285,284,746,555,553,76950,21353625.0,76396,76728.75
2425,92,76,30,59,302,301,243,242,621,545,543,73386,19997685.0,72842,73983.75
2426,74,62,17,39,156,155,114,113,94,270,268,17784,2400840.0,17515,18090.0
2427,70,61,19,34,154,153,151,150,141,305,303,23254,3546235.0,22950,23103.75
2428,49,37,10,30,135,134,113,112,76,248,246,15255,1891620.0,15008,15252.0
2429,18,14,3,9,94,93,123,122,54,217,215,11562,1254477.0,11346,11663.75
243,108,103,11,19,178,177,216,215,337,394,392,38448,7574256.0,38055,38612.0
2430,66,58,16,23,315,314,176,175,591,491,489,55440,13610520.0,54950,60024.75
2431,81,72,19,34,251,250,184,183,390,435,433,46184,10045020.0,45750,47088.75
2432,92,70,26,65,224,223,224,223,395,448,446,50176,11239424.0,49729,49952.0
2433,65,55,21,36,118,117,208,207,258,326,324,24544,4000672.0,24219,26406.0
2434,59,55,15,21,202,201,144,143,245,346,344,29088,5032224.0,28743,29756.0
2435,60,45,21,47,277,276,350,349,877,627,625,96950,30393825.0,96324,97968.75
2436,63,47,18,38,210,209,179,178,293,389,387,37590,7311255.0,37202,37635.75
2438,82,63,23,57,221,220,150,149,284,371,369,33150,6149325.0,32780,34224.75
2439,100,87,30,54,198,197,294,293,543,492,490,58212,14320152.0,57721,60270.0
244,176,137,53,125,469,468,365,364,1803,834,832,171185,71384145.0,170352,173472.0
2440,64,48,14,44,151,150,127,126,108,278,276,19177,2665603.0,18900,19182.0
2441,390,382,13,27,405,404,405,404,3147,810,808,164025,66430125.0,163216,163620.0
2442,73,59,22,48,111,110,173,172,132,284,282,19203,2726826.0,18920,20022.0
2443,103,85,30,62,219,218,261,260,483,480,478,57159,13718160.0,56680,57360.0
2444,61,41,17,55,207,206,252,251,366,459,457,52164,11971638.0,51706,52440.75
2446,97,79,30,61,168,167,251,250,441,419,417,42168,8834196.0,41750,43680.75
2447,64,57,22,33,161,160,127,126,124,288,286,20447,2944368.0,20160,20592.0
2448,78,72,24,33,200,199,154,153,347,354,352,30800,5451600.0,30447,31152.0
2449,49,44,16,23,254,253,463,462,1118,717,715,117602,42160317.0,116886,128163.75
245,37,29,10,23,165,164,226,225,322,391,389,37290,7290195.0,36900,38024.75
2450,47,33,15,35,116,115,208,207,205,324,322,24128,3908736.0,23805,26082.0
2451,84,75,21,37,168,167,151,150,164,319,317,25368,4046196.0,25050,25280.75
2452,46,37,17,32,110,109,136,135,100,246,244,14960,1840080.0,14715,15006.0
2453,80,57,24,67,132,131,161,160,188,293,291,21252,3113418.0,20960,21315.75
2454,67,60,15,25,174,173,175,174,201,349,347,30450,5313525.0,30102,30275.75
2455,52,44,19,32,396,395,220,219,1036,616,614,87120,26832960.0,86505,94556.0
2456,66,56,19,37,180,179,162,161,225,342,340,29160,4986360.0,28819,29070.0
2457,63,57,14,22,149,148,254,253,294,403,401,37846,7625969.0,37444,40400.75
2458,70,61,16,32,229,228,140,139,250,369,367,32060,5915070.0,31692,33855.75
2459,55,46,16,32,136,135,162,161,134,298,296,22032,3282768.0,21735,22052.0
246,55,49,17,25,164,163,214,213,207,378,376,35096,6633144.0,34719,35532.0
2460,127,119,18,32,242,241,191,190,304,433,431,46222,10007063.0,45790,46655.75
2461,81,67,28,53,164,163,280,279,587,444,442,45920,10194240.0,45477,49062.0
2462,86,71,24,49,187,186,162,161,288,349,347,30294,5286303.0,29946,30275.75
2463,73,59,23,48,181,180,263,262,474,444,442,47603,10567866.0,47160,49062.0
2464,35,30,12,20,202,201,99,98,110,301,299,19998,3009699.0,19698,22499.75
2465,49,46,14,18,101,100,174,173,101,275,273,17574,2416425.0,17300,18768.75
2466,39,36,9,12,75,74,104,103,36,179,177,7800,698100.0,7622,7920.75
2467,69,56,21,42,134,133,148,147,94,282,280,19832,2796312.0,19551,19740.0
2468,53,29,12,56,267,266,155,154,360,422,420,41385,8732235.0,40964,44310.0
2469,72,59,20,44,355,354,165,164,423,520,518,58575,15229500.0,58056,67340.0
247,58,50,20,31,121,120,155,154,109,276,274,18755,2588190.0,18480,18906.0
2470,82,72,26,43,162,161,195,194,182,357,355,31590,5638815.0,31234,31683.75
2471,50,46,12,17,218,217,146,145,239,364,362,31828,5792696.0,31465,32942.0
2472,58,48,13,30,214,213,130,129,251,344,342,27820,4785040.0,27477,29412.0
2473,74,70,18,24,209,208,119,118,122,328,326,24871,4078844.0,24544,26732.0
2474,29,23,13,23,132,131,245,244,260,377,375,32340,6096090.0,31964,35343.75
2475,112,94,31,65,196,195,256,255,471,452,450,50176,11339776.0,49725,50850.0
2476,66,47,24,59,202,201,187,186,263,389,387,37774,7347043.0,37386,37635.75
2477,48,42,14,24,248,247,307,306,751,555,553,76136,21127740.0,75582,76728.75
2478,45,38,12,22,125,124,225,224,217,350,348,28125,4921875.0,27776,30450.0
2479,39,32,11,23,167,166,163,162,127,330,328,27221,4491465.0,26892,27060.0
248,33,30,8,11,127,126,112,111,92,239,237,14224,1699768.0,13986,14160.75
2480,67,59,15,29,261,260,145,144,235,406,404,37845,7682535.0,37440,41006.0
2481,82,72,18,36,159,158,250,249,393,409,407,39750,8128875.0,39342,41615.75
2482,54,42,15,36,127,126,186,185,166,313,311,23622,3696843.0,23310,24335.75
2484,45,43,11,13,137,136,205,204,195,342,340,28085,4802535.0,27744,29070.0
2485,25,22,9,12,121,120,157,156,91,278,276,18997,2640583.0,18720,19182.0
2486,55,44,19,39,115,114,133,132,79,248,246,15295,1896580.0,15048,15252.0
2487,106,84,26,67,340,339,258,257,704,598,596,87720,26228280.0,87123,89102.0
2488,56,48,21,34,163,162,210,209,262,373,371,34230,6383895.0,33858,34595.75
2489,32,28,8,12,141,140,150,149,99,291,289,21150,3077325.0,20860,21024.75
249,79,63,25,55,174,173,188,187,294,362,360,32712,5920872.0,32351,32580.0
2490,40,25,14,40,160,159,208,207,220,368,366,33280,6123520.0,32913,33672.0
2492,93,73,25,63,166,165,294,293,373,460,458,48804,11224920.0,48345,52670.0
2493,49,43,18,28,218,217,156,155,184,374,372,34008,6359496.0,33635,34782.0
2494,52,45,20,31,252,251,155,154,286,407,405,39060,7948710.0,38654,41208.75
2495,49,43,13,21,127,126,130,129,110,257,255,16510,2121535.0,16254,16383.75
2497,85,68,31,62,194,193,247,246,396,441,439,47918,10565919.0,47478,48399.75
2498,47,37,13,31,133,132,78,77,50,211,209,10374,1094457.0,10164,11024.75
2499,48,39,15,31,135,134,117,116,77,252,250,15795,1990170.0,15544,15750.0
25,45,34,12,32,91,90,218,217,203,309,307,19838,3064971.0,19530,23715.75
250,83,68,26,50,174,173,242,241,359,416,414,42108,8758464.0,41693,43056.0
2500,90,70,18,56,141,140,257,256,293,398,396,36237,7211163.0,35840,39402.0
2502,87,71,24,53,209,208,164,163,237,373,371,34276,6392474.0,33904,34595.75
2503,36,29,10,22,76,75,101,100,29,177,175,7676,679326.0,7500,7743.75
2504,55,45,14,32,180,179,220,219,237,400,398,39600,7920000.0,39201,39800.0
2505,31,27,11,15,152,151,204,203,167,356,354,31008,5519424.0,30653,31506.0
2506,43,39,10,14,188,187,92,91,77,280,278,17296,2421440.0,17017,19460.0
2507,70,46,15,59,309,308,459,458,2125,768,766,141831,54463104.0,141064,147072.0
2508,105,86,23,59,267,266,187,186,404,454,452,49929,11333883.0,49476,51302.0
2509,78,66,21,43,152,151,173,172,200,325,323,26296,4273100.0,25972,26243.75
251,70,66,14,20,142,141,111,110,80,253,251,15762,1993893.0,15510,15875.75
2510,46,38,12,26,109,108,83,82,52,192,190,9047,868512.0,8856,9120.0
2511,86,70,26,56,206,205,185,184,248,391,389,38110,7450505.0,37720,38024.75
2512,37,28,11,27,112,111,189,188,111,301,299,21168,3185784.0,20868,22499.75
2513,88,77,28,47,305,304,228,227,628,533,531,69540,18532410.0,69008,70755.75
2514,28,22,5,13,149,148,130,129,155,279,277,19370,2702115.0,19092,19320.75
2515,78,66,28,48,184,183,154,153,139,338,336,28336,4788784.0,27999,28392.0
2516,92,77,30,58,296,295,156,155,332,452,450,46176,10435776.0,45725,50850.0
2517,53,39,16,42,147,146,291,290,410,438,436,42777,9368163.0,42340,47742.0
2518,90,75,32,59,193,192,249,248,376,442,440,48057,10620597.0,47616,48620.0
2519,84,66,28,60,235,234,215,214,386,450,448,50525,11368125.0,50076,50400.0
252,87,71,16,45,147,146,155,154,151,302,300,22785,3440535.0,22484,22650.0
2520,75,70,21,29,127,126,186,185,131,313,311,23622,3696843.0,23310,24335.75
2521,79,66,29,53,336,335,286,285,933,622,620,96096,29885856.0,95475,96410.0
2522,73,52,25,65,165,164,257,256,389,422,420,42405,8947455.0,41984,44310.0
2523,121,93,36,87,267,266,266,265,604,533,531,71022,18927363.0,70490,70755.75
2524,48,38,18,36,164,163,203,202,249,367,365,33292,6109082.0,32926,33488.75
2525,46,39,14,26,291,290,329,328,894,620,618,95739,29679090.0,95120,95790.0
2526,41,35,12,20,110,109,113,112,73,223,221,12430,1385945.0,12208,12320.75
2527,146,118,45,97,321,320,504,503,1799,825,823,161784,66735900.0,160960,169743.75
2528,171,170,7,7,178,177,178,177,178,356,354,31684,5639752.0,31329,31506.0
2529,46,37,14,28,205,204,83,82,95,288,286,17015,2450160.0,16728,20592.0
253,71,69,21,23,188,187,118,117,118,306,304,22184,3394152.0,21879,23256.0
2530,63,53,22,39,293,292,289,288,690,582,580,84677,24641007.0,84096,84390.0
2531,33,29,11,14,158,157,292,291,368,450,448,46136,10380600.0,45687,50400.0
2532,103,83,28,65,239,238,223,222,434,462,460,53297,12311607.0,52836,53130.0
2533,92,77,27,51,223,222,199,198,449,422,420,44377,9363547.0,43956,44310.0
2534,80,75,23,31,221,220,154,153,175,375,373,34034,6381375.0,33660,34968.75
2535,119,98,34,74,235,234,252,251,469,487,485,59220,14420070.0,58734,59048.75
2536,41,36,12,17,140,139,134,133,92,274,272,18760,2570120.0,18487,18632.0
2537,53,43,17,35,243,242,131,130,305,374,372,31833,5952771.0,31460,34782.0
2538,96,87,14,28,259,258,128,127,206,387,385,33152,6414912.0,32766,37248.75
2539,42,38,14,18,137,136,186,185,175,323,321,25482,4115343.0,25160,25920.75
254,38,34,12,18,161,160,145,144,153,306,304,23345,3571785.0,23040,23256.0
2540,28,26,9,11,125,124,154,153,105,279,277,19250,2685375.0,18972,19320.75
2541,47,40,10,22,149,148,158,157,188,307,305,23542,3613697.0,23236,23408.75
2542,62,57,16,24,185,184,139,138,247,324,322,25715,4165830.0,25392,26082.0
2543,64,50,14,40,189,188,148,147,177,337,335,27972,4713282.0,27636,28223.75
2544,88,72,25,55,189,188,201,200,277,390,388,37989,7407855.0,37600,37830.0
2545,16,15,3,3,186,185,88,87,85,274,272,16368,2242416.0,16095,18632.0
2546,70,59,21,37,141,140,184,183,145,325,323,25944,4215900.0,25620,26243.75
2547,53,39,17,39,152,151,202,201,192,354,352,30704,5434608.0,30351,31152.0
2548,121,99,44,82,301,300,285,284,773,586,584,85785,25135005.0,85200,85556.0
2549,49,41,19,33,159,158,165,164,158,324,322,26235,4250070.0,25912,26082.0
255,58,47,21,38,138,137,149,148,87,287,285,20562,2950647.0,20276,20448.75
2550,91,79,26,46,176,175,200,199,260,376,374,35200,6617600.0,34825,35156.0
2551,49,38,13,32,109,108,144,143,89,253,251,15696,1985544.0,15444,15875.75
2552,33,27,13,21,141,140,114,113,74,255,253,16074,2049435.0,15820,16128.75
2553,139,109,51,109,398,397,310,309,1437,708,706,123380,43676520.0,122673,124962.0
2554,62,48,17,42,223,222,160,159,267,383,381,35680,6832720.0,35298,36480.75
2555,46,41,8,16,130,129,177,176,122,307,305,23010,3532035.0,22704,23408.75
2556,64,55,14,30,136,135,143,142,129,279,277,19448,2712996.0,19170,19320.75
2557,54,43,20,40,136,135,203,202,209,339,337,27608,4679556.0,27270,28560.75
2558,35,31,11,16,165,164,160,159,178,325,323,26400,4290000.0,26076,26243.75
256,41,38,14,18,116,115,193,192,175,309,307,22388,3458946.0,22080,23715.75
2560,21,20,4,4,144,143,112,111,74,256,254,16128,2064384.0,15873,16256.0
2561,47,40,15,24,100,99,213,212,157,313,311,21300,3333450.0,20988,24335.75
2562,39,37,11,13,138,137,114,113,85,252,250,15732,1982232.0,15481,15750.0
2563,84,64,29,64,239,238,149,148,308,388,386,35611,6908534.0,35224,37442.0
2564,33,26,13,25,244,243,182,181,366,426,424,44408,9458904.0,43983,45156.0
2565,119,101,33,67,266,265,164,163,269,430,428,43624,9379160.0,43195,46010.0
2566,71,57,22,48,241,240,138,137,297,379,377,33258,6302391.0,32880,35720.75
2567,391,383,13,27,405,404,405,404,3097,810,808,164025,66430125.0,163216,163620.0
2568,63,55,20,34,194,193,122,121,134,316,314,23668,3739544.0,23353,24806.0
2569,45,40,11,19,152,151,121,120,78,273,271,18392,2510508.0,18120,18495.75
257,48,40,16,27,379,378,178,177,505,557,555,67462,18788167.0,66906,77283.75
2570,61,48,16,35,131,130,188,187,153,319,317,24628,3928166.0,24310,25280.75
2572,109,107,11,12,135,134,150,149,169,285,283,20250,2885625.0,19966,20163.75
2573,76,59,24,55,192,191,141,140,200,333,331,27072,4507488.0,26740,27555.75
2574,58,46,22,44,238,237,188,187,248,426,424,44744,9530472.0,44319,45156.0
2575,125,97,40,92,376,375,497,496,3794,873,871,186872,81569628.0,186000,190095.75
2576,70,64,11,19,138,137,102,101,67,240,238,14076,1689120.0,13837,14280.0
2577,71,53,15,47,196,195,178,177,233,374,372,34888,6524056.0,34515,34782.0
2578,30,26,8,14,204,203,259,258,494,463,461,52836,12231534.0,52374,53360.75
2579,26,20,4,14,183,182,100,99,128,283,281,18300,2589450.0,18018,19880.75
258,126,97,39,94,338,337,380,379,2349,718,716,128440,46109960.0,127723,128522.0
2580,99,80,25,61,152,151,215,214,211,367,365,32680,5996780.0,32314,33488.75
2581,37,30,12,22,182,181,117,116,114,299,297,21294,3183453.0,20996,22200.75
2582,52,42,19,37,138,137,151,150,120,289,287,20838,3011091.0,20550,20735.75
2583,58,48,17,35,231,230,215,214,366,446,444,49665,11075295.0,49220,49506.0
2584,67,61,17,27,190,189,120,119,122,310,308,22800,3534000.0,22491,23870.0
2585,25,23,6,7,108,107,133,132,71,241,239,14364,1730862.0,14124,14399.75
2586,77,68,18,32,168,167,199,198,251,367,365,33432,6134772.0,33066,33488.75
2587,76,62,23,47,198,197,180,179,274,378,376,35640,6735960.0,35263,35532.0
2588,60,51,15,26,122,121,174,173,110,296,294,21228,3141744.0,20933,21756.0
2589,68,57,22,42,159,158,189,188,173,348,346,30051,5228874.0,29704,30102.0
259,63,55,14,28,130,129,151,150,132,281,279,19630,2758015.0,19350,19599.75
2590,27,22,8,14,132,131,124,123,89,256,254,16368,2095104.0,16113,16256.0
2591,35,28,13,25,142,141,140,139,99,282,280,19880,2803080.0,19599,19740.0
2592,48,44,16,22,164,163,149,148,145,313,311,24436,3824234.0,24124,24335.75
2593,64,55,20,36,125,124,216,215,140,341,339,27000,4603500.0,26660,28899.75
2594,66,52,20,46,138,137,122,121,106,260,258,16836,2188680.0,16577,16770.0
2595,112,94,29,63,233,232,253,252,438,486,484,58949,14324607.0,58464,58806.0
2596,52,43,24,40,348,347,161,160,366,509,507,56028,14259126.0,55520,64515.75
2597,22,19,8,12,231,230,168,167,254,399,397,38808,7742196.0,38410,39600.75
2599,35,31,16,22,154,153,95,94,88,249,247,14630,1821435.0,14382,15375.75
26,45,39,13,23,123,122,87,86,40,210,208,10701,1123605.0,10492,10920.0
260,97,96,5,5,192,191,246,245,298,438,436,47232,10343808.0,46795,47742.0
2600,60,49,21,41,156,155,262,261,360,418,416,40872,8542248.0,40455,43472.0
2601,354,340,19,45,405,404,377,376,2209,782,780,152685,59699835.0,151904,152490.0
2602,38,33,11,17,179,178,123,122,131,302,300,22017,3324567.0,21716,22650.0
2603,51,34,20,51,134,133,189,188,206,323,321,25326,4090149.0,25004,25920.75
2604,75,62,23,44,189,188,205,204,220,394,392,38745,7632765.0,38352,38612.0
2605,37,31,10,16,166,165,255,254,320,421,419,42330,8910465.0,41910,44099.75
2606,104,80,32,72,347,346,546,545,3164,893,891,189462,84594783.0,188570,198915.75
2607,35,30,13,20,179,178,141,140,136,320,318,25239,4038240.0,24920,25440.0
2608,54,42,12,30,132,131,104,103,69,236,234,13728,1619904.0,13493,13806.0
2609,62,56,16,26,166,165,102,101,90,268,266,16932,2268888.0,16665,17822.0
2610,67,50,18,36,183,182,147,146,208,330,328,26901,4438665.0,26572,27060.0
2611,38,32,15,25,125,124,101,100,56,226,224,12625,1426625.0,12400,12656.0
2612,41,31,12,29,86,85,109,108,60,195,193,9374,913965.0,9180,9408.75
2613,66,47,19,55,106,105,154,153,117,260,258,16324,2122120.0,16065,16770.0
2614,72,60,19,37,153,152,213,212,256,366,364,32589,5963787.0,32224,33306.0
2615,31,29,7,8,139,138,100,99,58,239,237,13900,1661050.0,13662,14160.75
2616,26,24,7,9,84,83,106,105,45,190,188,8904,845880.0,8715,8930.0
2617,41,35,7,17,81,80,158,157,81,239,237,12798,1529361.0,12560,14160.75
2618,49,40,10,20,155,154,140,139,90,295,293,21700,3200750.0,21406,21608.75
2619,30,27,10,14,115,114,98,97,52,213,211,11270,1200255.0,11058,11235.75
262,23,21,7,8,89,88,165,164,85,254,252,14685,1864995.0,14432,16002.0
2620,35,28,14,25,206,205,110,109,134,316,314,22660,3580280.0,22345,24806.0
2621,38,30,10,22,145,144,180,179,215,325,323,26100,4241250.0,25776,26243.75
2622,46,38,14,28,131,130,99,98,90,230,228,12969,1491435.0,12740,13110.0
2623,38,29,10,24,171,170,94,93,108,265,263,16074,2129805.0,15810,17423.75
2624,31,26,12,19,173,172,285,284,330,458,456,49305,11290845.0,48848,52212.0
2625,62,55,20,32,249,248,146,145,427,395,393,36354,7179915.0,35960,38808.75
2626,84,67,31,62,333,332,524,523,3637,857,855,174492,74769822.0,173636,183183.75
2627,83,71,17,39,224,223,132,131,219,356,354,29568,5263104.0,29213,31506.0
2628,117,88,40,96,219,218,237,236,600,456,454,51903,11833884.0,51448,51756.0
2629,45,33,15,37,175,174,134,133,167,309,307,23450,3623025.0,23142,23715.75
263,47,38,11,26,87,86,107,106,41,194,192,9309,902973.0,9116,9312.0
2630,86,59,18,66,455,454,406,405,3962,861,859,184730,79526265.0,183870,184899.75
2631,145,119,32,82,299,298,322,321,1090,621,619,96278,29894319.0,95658,96099.75
2632,46,37,14,28,255,254,235,234,419,490,488,59925,14681625.0,59436,59780.0
2633,41,32,13,28,74,73,191,190,74,265,263,14134,1872755.0,13870,17423.75
2634,68,52,22,52,162,161,152,151,187,314,312,24624,3865968.0,24311,24492.0
2635,41,31,7,25,189,188,132,131,141,321,319,24948,4004154.0,24628,25599.75
2636,63,40,22,65,155,154,178,177,236,333,331,27590,4593735.0,27258,27555.75
2637,75,67,17,31,125,124,115,114,53,240,238,14375,1725000.0,14136,14280.0
2638,48,42,13,22,152,151,101,100,79,253,251,15352,1942028.0,15100,15875.75
2639,45,35,13,30,106,105,136,135,78,242,240,14416,1744336.0,14175,14520.0
264,53,45,14,27,83,82,115,114,50,198,196,9545,944955.0,9348,9702.0
2640,88,74,23,49,180,179,128,127,142,308,306,23040,3548160.0,22733,23562.0
2641,60,46,17,43,118,117,226,225,181,344,342,26668,4586896.0,26325,29412.0
2642,35,27,10,20,137,136,120,119,77,257,255,16440,2112540.0,16184,16383.75
2644,33,28,6,14,163,162,145,144,158,308,306,23635,3639790.0,23328,23562.0
2645,47,42,15,22,105,104,116,115,67,221,219,12180,1345890.0,11960,12099.75
2646,161,158,9,13,170,169,170,169,172,340,338,28900,4913000.0,28561,28730.0
2647,51,44,18,30,219,218,160,159,308,379,377,35040,6640080.0,34662,35720.75
2648,78,65,33,55,332,331,296,295,1209,628,626,98272,30857408.0,97645,98282.0
2649,47,43,15,20,142,141,92,91,66,234,232,13064,1528488.0,12831,13572.0
265,67,61,25,34,146,145,142,141,134,288,286,20732,2985408.0,20445,20592.0
2650,39,37,12,14,144,143,116,115,104,260,258,16704,2171520.0,16445,16770.0
2651,140,138,9,11,170,169,147,146,133,317,315,24990,3960915.0,24674,24963.75
2652,47,44,13,16,129,128,181,180,139,310,308,23349,3619095.0,23040,23870.0
2653,55,44,19,35,215,214,118,117,133,333,331,25370,4224105.0,25038,27555.75
2654,39,22,12,40,282,281,128,127,317,410,408,36096,7399680.0,35687,41820.0
2655,47,42,16,23,147,146,84,83,55,231,229,12348,1426194.0,12118,13224.75
2656,56,47,13,25,177,176,88,87,79,265,263,15576,2063820.0,15312,17423.75
2657,20,19,6,6,194,193,128,127,130,322,320,24832,3997952.0,24511,25760.0
2659,47,43,11,14,141,140,146,145,137,287,285,20586,2954091.0,20300,20448.75
266,63,54,16,31,144,143,129,128,101,273,271,18576,2535624.0,18304,18495.75
2660,123,107,40,70,243,242,266,265,519,509,507,64638,16450371.0,64130,64515.75
2661,60,57,10,14,106,105,81,80,40,187,185,8586,802791.0,8400,8648.75
2662,92,90,8,10,178,177,101,100,90,279,277,17978,2507931.0,17700,19320.75
2663,135,133,9,11,239,238,170,169,277,409,407,40630,8308835.0,40222,41615.75
2664,71,65,16,22,173,172,201,200,370,374,372,34773,6502551.0,34400,34782.0
2665,77,66,24,44,207,206,125,124,187,332,330,25875,4295250.0,25544,27390.0
2667,171,170,7,7,178,177,178,177,173,356,354,31684,5639752.0,31329,31506.0
2668,60,47,18,42,183,182,144,143,166,327,325,26352,4308552.0,26026,26568.75
2669,51,39,12,34,144,143,101,100,87,245,243,14544,1781640.0,14300,14883.75
267,34,24,8,25,277,276,182,181,379,459,457,50414,11570013.0,49956,52440.75
2670,170,169,8,8,178,177,178,177,174,356,354,31684,5639752.0,31329,31506.0
2671,51,44,17,26,133,132,260,259,212,393,391,34580,6794970.0,34188,38415.75
2672,61,43,13,44,135,134,190,189,186,325,323,25650,4168125.0,25326,26243.75
2673,73,59,29,54,170,169,375,374,648,545,543,63750,17371875.0,63206,73983.75
2674,107,79,34,86,262,261,307,306,728,569,567,80434,22883473.0,79866,80655.75
2675,94,88,36,46,467,466,518,517,8255,985,983,241906,119138705.0,240922,242063.75
2676,57,49,20,33,242,241,183,182,260,425,423,44286,9410775.0,43862,44943.75
2677,41,29,15,36,100,99,104,103,43,204,202,10400,1060800.0,10197,10302.0
2678,98,85,28,52,214,213,220,219,384,434,432,47080,10216360.0,46647,46872.0
2679,43,35,13,27,159,158,193,192,201,352,350,30687,5400912.0,30336,30800.0
268,34,30,10,13,78,77,130,129,52,208,206,10140,1054560.0,9933,10712.0
2680,85,78,11,23,116,115,124,123,80,240,238,14384,1726080.0,14145,14280.0
2681,58,49,18,34,271,270,156,155,309,427,425,42276,9025926.0,41850,45368.75
2682,48,42,11,21,214,213,124,123,184,338,336,26536,4484584.0,26199,28392.0
2683,74,56,27,59,269,268,218,217,467,487,485,58642,14279327.0,58156,59048.75
2684,75,64,22,42,262,261,174,173,353,436,434,45588,9938184.0,45153,47306.0
2685,171,170,7,7,178,177,178,177,163,356,354,31684,5639752.0,31329,31506.0
2686,64,54,19,36,96,95,159,158,89,255,253,15264,1946160.0,15010,16128.75
2687,126,106,36,73,356,355,310,309,1065,666,664,110360,36749880.0,109695,110556.0
2688,90,79,17,36,133,132,261,260,260,394,392,34713,6838461.0,34320,38612.0
2689,64,54,18,33,144,143,170,169,137,314,312,24480,3843360.0,24167,24492.0
269,77,64,29,53,206,205,218,217,353,424,422,44908,9520496.0,44485,44732.0
2690,68,51,21,52,196,195,202,201,290,398,396,39592,7878808.0,39195,39402.0
2691,59,49,18,36,254,253,162,161,235,416,414,41148,8558784.0,40733,43056.0
2692,25,24,9,9,78,77,253,252,161,331,329,19734,3265977.0,19404,27224.75
2693,109,88,30,70,303,302,249,248,678,552,550,75447,20823372.0,74896,75900.0
2694,72,65,19,31,523,522,182,181,1008,705,703,95186,33553065.0,94482,123903.75
2695,77,54,27,69,166,165,242,241,293,408,406,40172,8195088.0,39765,41412.0
2696,62,54,23,37,200,199,132,131,164,332,330,26400,4382400.0,26069,27390.0
2697,78,70,18,32,111,110,190,189,227,301,299,21090,3174045.0,20790,22499.75
2698,75,59,24,51,243,242,318,317,648,561,559,77274,21675357.0,76714,78399.75
2699,35,31,12,18,174,173,93,92,110,267,265,16182,2160297.0,15916,17688.75
27,57,46,19,36,209,208,132,131,199,341,339,27588,4703754.0,27248,28899.75
270,37,35,11,13,148,147,176,175,174,324,322,26048,4219776.0,25725,26082.0
2700,55,45,15,33,140,139,166,165,124,306,304,23240,3555720.0,22935,23256.0
2701,55,43,16,33,144,143,255,254,236,399,397,36720,7325640.0,36322,39600.75
2702,88,74,26,51,214,213,295,294,503,509,507,63130,16066585.0,62622,64515.75
2703,48,30,12,41,312,311,326,325,1021,638,636,101712,32446128.0,101075,101442.0
2704,68,54,25,51,202,201,338,337,847,540,538,68276,18434520.0,67737,72630.0
2705,130,98,35,95,469,468,290,289,1666,759,757,136010,51615795.0,135252,143640.75
2706,39,31,11,25,70,69,133,132,65,203,201,9310,944965.0,9108,10200.75
2707,56,45,14,34,157,156,234,233,373,391,389,36738,7182279.0,36348,38024.75
2708,68,58,21,38,142,141,231,230,268,373,371,32802,6117573.0,32430,34595.75
2709,59,51,21,35,183,182,137,136,147,320,318,25071,4011360.0,24752,25440.0
271,80,67,27,51,192,191,280,279,402,472,470,53760,12687360.0,53289,55460.0
2710,65,52,15,33,168,167,137,136,185,305,303,23016,3509940.0,22712,23103.75
2711,121,102,46,80,383,382,443,442,2273,826,824,169669,70073297.0,168844,170156.0
2712,17,16,5,5,129,128,155,154,102,284,282,19995,2839290.0,19712,20022.0
2713,110,105,11,18,331,330,178,177,520,509,507,58918,14994631.0,58410,64515.75
2715,20,19,4,4,94,93,97,96,38,191,189,9118,870769.0,8928,9024.75
2716,139,116,40,81,327,326,310,309,1441,637,635,101370,32286345.0,100734,101123.75
2717,38,30,10,24,99,98,141,140,58,240,238,13959,1675080.0,13720,14280.0
2718,36,27,14,30,177,176,195,194,222,372,370,34515,6419790.0,34144,34410.0
2719,56,47,16,30,150,149,260,259,242,410,408,39000,7995000.0,38591,41820.0
272,19,18,5,5,160,159,87,86,80,247,245,13920,1719120.0,13674,15128.75
2720,34,33,10,10,93,92,115,114,63,208,206,10695,1112280.0,10488,10712.0
2721,35,26,10,22,117,116,94,93,59,211,209,10998,1160289.0,10788,11024.75
2722,62,53,21,37,304,303,352,351,1475,656,654,107008,35098624.0,106353,107256.0
2723,66,57,15,30,377,376,393,392,1637,770,768,148161,57041985.0,147392,147840.0
2725,48,34,11,34,181,180,190,189,238,371,369,34390,6379345.0,34020,34224.75
2726,41,34,8,20,174,173,97,96,135,271,269,16878,2286969.0,16608,18224.75
2727,95,81,33,59,303,302,223,222,444,526,524,67569,17770647.0,67044,68906.0
2728,76,64,14,36,117,116,135,134,98,252,250,15795,1990170.0,15544,15750.0
2729,37,31,8,15,137,136,92,91,55,229,227,12604,1443158.0,12376,12995.75
273,46,39,17,29,166,165,102,101,86,268,266,16932,2268888.0,16665,17822.0
2730,57,53,17,23,111,110,154,153,81,265,263,17094,2264955.0,16830,17423.75
2731,30,23,13,23,142,141,170,169,133,312,310,24140,3765840.0,23829,24180.0
2732,49,42,11,17,129,128,178,177,203,307,305,22962,3524667.0,22656,23408.75
2733,30,27,11,15,92,91,180,179,73,272,270,16560,2252160.0,16289,18360.0
2734,38,32,8,16,126,125,95,94,71,221,219,11970,1322685.0,11750,12099.75
2735,55,48,15,26,214,213,202,201,305,416,414,43228,8991424.0,42813,43056.0
2736,38,31,14,26,125,124,229,228,215,354,352,28625,5066625.0,28272,31152.0
2737,68,48,22,55,191,190,155,154,207,346,344,29605,5121665.0,29260,29756.0
2738,42,36,13,20,145,144,192,191,206,337,335,27840,4691040.0,27504,28223.75
2739,88,77,26,46,169,168,202,201,231,371,369,34138,6332599.0,33768,34224.75
274,43,37,13,19,101,100,170,169,164,271,269,17170,2326535.0,16900,18224.75
2740,78,63,25,53,267,266,211,210,545,478,476,56337,13464543.0,55860,56882.0
2741,81,65,25,55,280,279,310,309,784,590,588,86800,25606000.0,86211,86730.0
2742,78,62,20,48,153,152,142,141,148,295,293,21726,3204585.0,21432,21608.75
2743,50,45,12,19,95,94,125,124,50,220,218,11875,1306250.0,11656,11990.0
2744,41,37,8,13,94,93,158,157,90,252,250,14852,1871352.0,14601,15750.0
2745,50,46,15,21,134,133,157,156,124,291,289,21038,3061029.0,20748,21024.75
2746,70,51,23,59,217,216,141,140,236,358,356,30597,5476863.0,30240,31862.0
2747,77,61,19,49,147,146,246,245,268,393,391,36162,7105833.0,35770,38415.75
2748,98,79,28,62,176,175,228,227,301,404,402,40128,8105856.0,39725,40602.0
2749,64,56,18,32,181,180,132,131,132,313,311,23892,3739098.0,23580,24335.75
275,35,24,10,27,131,130,223,222,232,354,352,29213,5170701.0,28860,31152.0
2750,55,49,14,20,92,91,135,134,64,227,225,12420,1409670.0,12194,12768.75
2751,52,46,15,24,191,190,223,222,604,414,412,42593,8816751.0,42180,42642.0
2752,49,37,12,34,165,164,138,137,205,303,301,22770,3449655.0,22468,22800.75
2753,43,34,10,19,132,131,196,195,201,328,326,25872,4243008.0,25545,26732.0
2754,63,57,15,25,135,134,98,97,93,233,231,13230,1541295.0,12998,13455.75
2755,68,57,19,39,165,164,196,195,298,361,359,32340,5837370.0,31980,32399.75
2756,95,66,29,84,165,164,249,248,375,414,412,41085,8504595.0,40672,42642.0
2757,62,57,20,25,143,142,168,167,222,311,309,24024,3735732.0,23714,24024.75
2758,73,65,16,30,92,91,112,111,43,204,202,10304,1051008.0,10101,10302.0
2759,53,48,16,24,119,118,192,191,116,311,309,22848,3552864.0,22538,24024.75
276,257,256,10,10,267,266,267,266,595,534,532,71289,19034163.0,70756,71022.0
2760,44,37,12,23,123,122,179,178,117,302,300,22017,3324567.0,21716,22650.0
2761,29,24,8,14,118,117,94,93,60,212,210,11092,1175752.0,10881,11130.0
2762,63,57,16,26,107,106,99,98,63,206,204,10593,1091079.0,10388,10506.0
2763,56,50,16,26,115,114,137,136,86,252,250,15755,1985130.0,15504,15750.0
2764,123,97,37,87,373,372,282,281,1494,655,653,105186,34448415.0,104532,106928.75
2765,86,68,26,59,206,205,307,306,503,513,511,63242,16221573.0,62730,65535.75
2766,45,38,11,22,94,93,134,133,70,228,226,12596,1435944.0,12369,12882.0
2767,54,46,10,24,153,152,74,73,70,227,225,11322,1285047.0,11096,12768.75
2769,53,44,11,21,147,146,127,126,136,274,272,18669,2557653.0,18396,18632.0
277,43,37,14,24,144,143,149,148,153,293,291,21456,3143304.0,21164,21315.75
2770,77,66,19,39,121,120,173,172,113,294,292,20933,3077151.0,20640,21462.0
2771,257,256,11,11,267,266,271,270,620,538,536,72357,19464033.0,71820,72092.0
2772,99,82,25,57,244,243,267,266,617,511,509,65148,16645314.0,64638,65024.75
2773,53,38,17,45,147,146,163,162,137,310,308,23961,3713955.0,23652,23870.0
2774,36,30,14,23,250,249,174,173,355,424,422,43500,9222000.0,43077,44732.0
2775,43,37,8,18,106,105,127,126,72,233,231,13462,1568323.0,13230,13455.75
2777,104,83,27,66,167,166,243,242,357,410,408,40581,8319105.0,40172,41820.0
2778,106,101,11,19,193,192,178,177,251,371,369,34354,6372667.0,33984,34224.75
2779,114,90,41,85,395,394,278,277,1212,673,671,109810,36951065.0,109138,112895.75
278,33,29,10,16,103,102,88,87,39,191,189,9064,865612.0,8874,9024.75
2780,45,42,13,16,152,151,112,111,83,264,262,17024,2247168.0,16761,17292.0
2781,47,40,14,25,170,169,82,81,67,252,250,13940,1756440.0,13689,15750.0
2782,52,42,16,29,129,128,132,131,88,261,259,17028,2222154.0,16768,16899.75
2783,44,36,10,18,81,80,161,160,108,242,240,13041,1577961.0,12800,14520.0
2784,68,53,21,49,144,143,170,169,178,314,312,24480,3843360.0,24167,24492.0
2785,65,56,22,38,156,155,197,196,216,353,351,30732,5424198.0,30380,30975.75
2786,72,61,22,39,156,155,279,278,256,435,433,43524,9466470.0,43090,47088.75
2788,82,77,21,29,106,105,191,190,132,297,295,20246,3006531.0,19950,21903.75
2789,49,42,14,25,135,134,108,107,80,243,241,14580,1771470.0,14338,14640.75
279,72,59,22,46,221,220,248,247,362,469,467,54808,12852476.0,54340,54755.75
2790,37,32,8,12,97,96,94,93,35,191,189,9118,870769.0,8928,9024.75
2791,54,43,18,38,178,177,149,148,161,327,325,26522,4336347.0,26196,26568.75
2792,68,52,22,46,128,127,139,138,105,267,265,17792,2375232.0,17526,17688.75
2793,68,56,22,43,159,158,144,143,111,303,301,22896,3468744.0,22594,22800.75
2794,119,118,6,6,147,146,124,123,88,271,269,18228,2469894.0,17958,18224.75
2795,59,51,20,34,269,268,130,129,213,399,397,34970,6976515.0,34572,39600.75
2796,226,211,37,65,269,268,447,446,1733,716,714,120243,43046994.0,119528,127806.0
2797,100,96,10,16,124,123,178,177,118,302,300,22072,3332872.0,21771,22650.0
2798,57,47,9,24,102,101,138,137,118,240,238,14076,1689120.0,13837,14280.0
2799,57,46,16,36,156,155,152,151,118,308,306,23712,3651648.0,23405,23562.0
28,35,30,15,23,268,267,213,212,829,481,479,57084,13728702.0,56604,57599.75
280,55,48,18,30,225,224,113,112,194,338,336,25425,4296825.0,25088,28392.0
2800,68,56,16,34,145,144,134,133,177,279,277,19430,2710485.0,19152,19320.75
2801,62,52,15,33,170,169,129,128,125,299,297,21930,3278535.0,21632,22200.75
2803,56,44,11,30,310,309,179,178,526,489,487,55490,13567305.0,55002,59535.75
2804,49,39,16,34,108,107,159,158,100,267,265,17172,2292462.0,16906,17688.75
2805,54,48,11,18,135,134,91,90,63,226,224,12285,1388205.0,12060,12656.0
2806,48,41,17,29,190,189,166,165,189,356,354,31540,5614120.0,31185,31506.0
2807,40,29,9,29,128,127,121,120,120,249,247,15488,1928256.0,15240,15375.75
2808,205,201,20,26,239,238,262,261,579,501,499,62618,15685809.0,62118,62499.75
2809,96,79,39,71,460,459,260,259,953,720,718,119600,43056000.0,118881,129240.0
281,64,55,23,39,141,140,260,259,311,401,399,36660,7350330.0,36260,39999.75
2810,101,87,25,50,149,148,244,243,236,393,391,36356,7143954.0,35964,38415.75
2811,53,47,17,27,108,107,260,259,171,368,366,28080,5166720.0,27713,33672.0
2812,112,89,40,82,338,337,261,260,777,599,597,88218,26421291.0,87620,89400.75
2813,48,41,15,27,150,149,112,111,97,262,260,16800,2200800.0,16539,17030.0
2814,61,49,18,33,273,272,499,498,1943,772,770,136227,52583622.0,135456,148610.0
2815,119,118,6,6,124,123,170,169,112,294,292,21080,3098760.0,20787,21462.0
2816,50,40,12,26,99,98,157,156,104,256,254,15543,1989504.0,15288,16256.0
2817,65,58,8,19,125,124,182,181,137,307,305,22750,3492125.0,22444,23408.75
2819,70,58,26,47,264,263,205,204,359,469,467,54120,12691140.0,53652,54755.75
282,97,89,33,47,266,265,298,297,652,564,562,79268,22353576.0,78705,79242.0
2820,65,57,15,29,126,125,129,128,93,255,253,16254,2072385.0,16000,16128.75
2821,31,30,15,15,299,298,106,105,171,405,403,31694,6418035.0,31290,40803.75
2822,103,86,32,63,230,229,260,259,441,490,488,59800,14651000.0,59311,59780.0
2823,97,90,31,43,199,198,235,234,334,434,432,46765,10148005.0,46332,46872.0
2824,118,117,7,7,124,123,239,238,177,363,361,29636,5378934.0,29274,32760.75
2825,47,40,13,25,114,113,173,172,114,287,285,19722,2830107.0,19436,20448.75
2826,78,57,27,66,278,277,243,242,660,521,519,67554,17597817.0,67034,67599.75
2827,45,33,11,33,257,256,176,175,458,433,431,45232,9792728.0,44800,46655.75
2828,42,33,13,26,143,142,115,114,112,258,256,16445,2121405.0,16188,16512.0
283,65,60,13,18,93,92,129,128,55,222,220,11997,1331667.0,11776,12210.0
2830,38,26,11,27,272,271,287,286,817,559,557,78064,21818888.0,77506,77840.75
2831,37,35,13,14,102,101,252,251,134,354,352,25704,4549608.0,25351,31152.0
2832,46,28,8,42,138,137,135,134,117,273,271,18630,2542995.0,18358,18495.75
2834,33,27,9,16,127,126,206,205,150,333,331,26162,4355973.0,25830,27555.75
2835,142,119,51,95,414,413,461,460,2624,875,873,190854,83498625.0,189980,190968.75
2836,54,43,17,35,202,201,236,235,322,438,436,47672,10440168.0,47235,47742.0
2837,50,40,14,30,126,125,193,192,166,319,317,24318,3878721.0,24000,25280.75
2838,51,41,13,29,102,101,125,124,66,227,225,12750,1447125.0,12524,12768.75
2839,48,44,13,19,146,145,104,103,107,250,248,15184,1898000.0,14935,15500.0
284,47,40,13,25,94,93,151,150,86,245,243,14194,1738765.0,13950,14883.75
2840,110,98,21,40,165,164,182,181,188,347,345,30030,5210205.0,29684,29928.75
2841,83,71,24,45,192,191,249,248,370,441,439,47808,10541664.0,47368,48399.75
2842,88,73,33,61,248,247,237,236,429,485,483,58776,14253180.0,58292,58563.75
2843,257,256,10,10,267,266,267,266,574,534,532,71289,19034163.0,70756,71022.0
2844,139,105,54,120,463,462,301,300,1655,764,762,139363,53236666.0,138600,145542.0
2845,77,61,22,51,256,255,156,155,454,412,410,39936,8226816.0,39525,42230.0
2846,46,38,12,23,97,96,108,107,50,205,203,10476,1073790.0,10272,10403.75
2847,141,120,46,86,257,256,416,415,1097,673,671,106912,35975888.0,106240,112895.75
2848,47,33,17,42,103,102,87,86,65,190,188,8961,851295.0,8772,8930.0
2849,34,29,14,20,225,224,212,211,310,437,435,47700,10422450.0,47264,47523.75
285,50,43,12,24,223,222,280,279,1003,503,501,62440,15703660.0,61938,63000.75
2850,67,62,17,22,119,118,148,147,69,267,265,17612,2351202.0,17346,17688.75
2851,53,43,12,28,154,153,252,251,323,406,404,38808,7878024.0,38403,41006.0
2852,95,79,24,54,160,159,183,182,251,343,341,29280,5021520.0,28938,29240.75
2853,251,250,11,11,323,322,269,268,1125,592,590,86887,25718552.0,86296,87320.0
2855,52,44,15,28,105,104,166,165,110,271,269,17430,2361765.0,17160,18224.75
2856,161,160,10,10,193,192,285,284,517,478,476,55005,13146195.0,54528,56882.0
2857,53,39,21,47,385,384,421,420,1949,806,804,162085,65320255.0,161280,162006.0
2858,113,95,35,68,239,238,336,335,651,575,573,80304,23087400.0,79730,82368.75
2859,55,43,22,42,233,232,179,178,221,412,410,41707,8591642.0,41296,42230.0
286,53,48,18,25,132,131,154,153,127,286,284,20328,2906904.0,20043,20306.0
2860,54,46,18,32,243,242,156,155,251,399,397,37908,7562646.0,37510,39600.75
2862,52,48,15,21,110,109,124,123,62,234,232,13640,1595880.0,13407,13572.0
2863,39,31,10,22,148,147,112,111,92,260,258,16576,2154880.0,16317,16770.0
2864,80,69,28,48,244,243,148,147,187,392,390,36112,7077952.0,35721,38220.0
2865,104,85,32,64,342,341,412,411,1697,754,752,140904,53120808.0,140151,141752.0
2866,71,59,19,40,223,222,225,224,339,448,446,50175,11239200.0,49728,49952.0
2867,52,40,13,35,192,191,130,129,208,322,320,24960,4018560.0,24639,25760.0
2868,30,29,9,9,88,87,220,219,151,308,306,19360,2981440.0,19053,23562.0
2869,50,33,9,41,180,179,179,178,301,359,357,32220,5783490.0,31862,32040.75
287,39,31,15,27,219,218,191,190,305,410,408,41829,8574945.0,41420,41820.0
2871,80,67,23,45,149,148,247,246,172,396,394,36803,7286994.0,36408,39006.0
2872,47,42,11,17,104,103,86,85,39,190,188,8944,849680.0,8755,8930.0
2873,50,41,15,31,138,137,129,128,107,267,265,17802,2376567.0,17536,17688.75
2874,55,46,19,35,135,134,112,111,93,247,245,15120,1867320.0,14874,15128.75
2875,49,33,11,34,127,126,248,247,238,375,373,31496,5905500.0,31122,34968.75
2876,69,59,14,31,157,156,138,137,121,295,293,21666,3195735.0,21372,21608.75
2877,58,43,16,39,145,144,185,184,206,330,328,26825,4426125.0,26496,27060.0
2878,76,54,27,69,260,259,159,158,263,419,417,41340,8660730.0,40922,43680.75
2880,54,46,10,24,135,134,78,77,61,213,211,10530,1121445.0,10318,11235.75
2881,90,77,28,52,192,191,278,277,404,470,468,53376,12543360.0,52907,54990.0
2882,108,98,29,47,233,232,163,162,355,396,394,37979,7519842.0,37584,39006.0
2883,108,89,33,69,308,307,202,201,451,510,508,62216,15865080.0,61707,64770.0
2884,58,51,16,28,195,194,219,218,267,414,412,42705,8839935.0,42292,42642.0
2885,71,58,27,50,265,264,326,325,593,591,589,86390,25528245.0,85800,87024.75
2886,42,32,10,22,102,101,97,96,38,199,197,9894,984453.0,9696,9800.75
2887,58,45,13,31,118,117,95,94,67,213,211,11210,1193865.0,10998,11235.75
2888,257,256,10,10,267,266,267,266,596,534,532,71289,19034163.0,70756,71022.0
2889,15,13,4,6,129,128,100,99,90,229,227,12900,1477050.0,12672,12995.75
289,50,42,17,31,233,232,157,156,215,390,388,36581,7133295.0,36192,37830.0
2890,33,28,8,16,139,138,217,216,173,356,354,30163,5369014.0,29808,31506.0
2891,104,100,9,15,178,177,193,192,262,371,369,34354,6372667.0,33984,34224.75
2892,54,44,17,32,235,234,270,269,709,505,503,63450,16021125.0,62946,63503.75
2893,89,71,31,63,180,179,191,190,188,371,369,34380,6377490.0,34010,34224.75
2894,71,51,29,67,282,281,183,182,501,465,463,51606,11998395.0,51142,53823.75
2895,71,54,24,53,187,186,146,145,194,333,331,27302,4545783.0,26970,27555.75
2896,49,35,13,37,148,147,143,142,126,291,289,21164,3079362.0,20874,21024.75
2897,50,38,16,33,186,185,202,201,254,388,386,37572,7288968.0,37185,37442.0
2898,61,42,19,51,125,124,113,112,86,238,236,14125,1680875.0,13888,14042.0
2899,91,79,30,52,214,213,183,182,398,397,395,39162,7773657.0,38766,39203.75
29,136,119,29,61,357,356,267,266,789,624,622,95319,29739528.0,94696,97032.0
290,52,36,13,42,129,128,105,104,97,234,232,13545,1584765.0,13312,13572.0
2900,56,40,19,49,186,185,232,231,281,418,416,43152,9018768.0,42735,43472.0
2901,42,36,15,23,93,92,129,128,59,222,220,11997,1331667.0,11776,12210.0
2903,47,38,15,30,149,148,178,177,169,327,325,26522,4336347.0,26196,26568.75
2904,43,38,16,24,167,166,175,174,186,342,340,29225,4997475.0,28884,29070.0
2905,52,40,18,40,155,154,112,111,103,267,265,17360,2317560.0,17094,17688.75
2906,106,87,30,65,347,346,318,317,1499,665,663,110346,36690045.0,109682,110223.75
2907,111,92,41,77,495,494,279,278,1677,774,772,138105,53446635.0,137332,149382.0
2908,71,58,20,43,179,178,183,182,242,362,360,32757,5929017.0,32396,32580.0
2909,35,27,12,25,131,130,92,91,58,223,221,12052,1343798.0,11830,12320.75
291,64,50,20,46,156,155,209,208,302,365,363,32604,5950230.0,32240,33123.75
2910,66,54,19,40,156,155,147,146,132,303,301,22932,3474198.0,22630,22800.75
2911,32,25,10,20,218,217,252,251,535,470,468,54936,12909960.0,54467,54990.0
2912,74,66,26,39,262,261,203,202,370,465,463,53186,12365745.0,52722,53823.75
2913,55,41,13,37,166,165,252,251,447,418,416,41832,8742888.0,41415,43472.0
2914,60,48,18,39,302,301,347,346,970,649,647,104794,34005653.0,104146,104975.75
2915,34,31,11,15,101,100,248,247,169,349,347,25048,4370876.0,24700,30275.75
2916,28,18,10,26,271,270,222,221,446,493,491,60162,14829933.0,59670,60515.75
2917,54,44,17,34,121,120,168,167,104,289,287,20328,2937396.0,20040,20735.75
2918,39,32,14,25,191,190,277,276,405,468,466,52907,12380238.0,52440,54522.0
2919,74,51,20,64,267,266,256,255,735,523,521,68352,17874048.0,67830,68120.75
292,98,85,28,51,196,195,175,174,241,371,369,34300,6362650.0,33930,34224.75
2920,43,38,11,18,223,222,228,227,512,451,449,50844,11465322.0,50394,50624.75
2921,80,61,19,54,157,156,176,175,237,333,331,27632,4600728.0,27300,27555.75
2922,69,66,12,16,192,191,114,113,113,306,304,21888,3348864.0,21583,23256.0
2923,42,33,16,28,110,109,97,96,59,207,205,10670,1104345.0,10464,10608.75
2924,82,69,15,38,136,135,167,166,144,303,301,22712,3440868.0,22410,22800.75
2925,45,38,13,25,181,180,184,183,252,365,363,33304,6077980.0,32940,33123.75
2926,171,170,7,7,178,177,178,177,173,356,354,31684,5639752.0,31329,31506.0
2927,50,45,13,18,124,123,169,168,161,293,291,20956,3070054.0,20664,21315.75
2928,60,49,14,29,180,179,155,154,241,335,333,27900,4673250.0,27566,27888.75
2929,49,42,12,24,90,89,140,139,64,230,228,12600,1449000.0,12371,13110.0
293,57,45,22,43,185,184,152,151,166,337,335,28120,4738220.0,27784,28223.75
2930,99,81,27,60,284,283,419,418,1371,703,701,118996,41827094.0,118294,123200.75
2932,82,77,13,20,124,123,136,135,99,260,258,16864,2192320.0,16605,16770.0
2933,43,36,13,25,157,156,94,93,62,251,249,14758,1852129.0,14508,15624.75
2934,44,36,11,25,166,165,99,98,83,265,263,16434,2177505.0,16170,17423.75
2935,54,45,15,31,214,213,189,188,300,403,401,40446,8149869.0,40044,40400.75
2936,54,49,11,17,88,87,132,131,57,220,218,11616,1277760.0,11397,11990.0
2937,49,45,16,22,104,103,134,133,78,238,236,13936,1658384.0,13699,14042.0
2938,115,101,38,64,256,255,315,314,817,571,569,80640,23022720.0,80070,81224.75
2939,55,48,14,26,141,140,151,150,161,292,290,21291,3108486.0,21000,21170.0
294,84,63,31,67,172,171,187,186,166,359,357,32164,5773438.0,31806,32040.75
2940,46,39,14,24,119,118,97,96,61,216,214,11543,1246644.0,11328,11556.0
2941,55,43,14,34,133,132,152,151,104,285,283,20216,2880780.0,19932,20163.75
2942,120,105,31,56,484,483,348,347,5231,832,830,168432,70067712.0,167601,172640.0
2944,81,63,22,53,165,164,181,180,295,346,344,29865,5166645.0,29520,29756.0
2945,38,33,13,20,110,109,182,181,109,292,290,20020,2922920.0,19729,21170.0
2946,62,50,18,38,101,100,187,186,147,288,286,18887,2719728.0,18600,20592.0
2947,43,37,15,25,102,101,169,168,90,271,269,17238,2335749.0,16968,18224.75
2948,48,42,14,20,191,190,92,91,110,283,281,17572,2486438.0,17290,19880.75
2949,31,28,9,13,155,154,254,253,332,409,407,39370,8051165.0,38962,41615.75
295,53,46,12,22,146,145,171,170,130,317,315,24966,3957111.0,24650,24963.75
2950,47,42,12,20,176,175,94,93,76,270,268,16544,2233440.0,16275,18090.0
2951,66,57,20,36,184,183,170,169,234,354,352,31280,5536560.0,30927,31152.0
2952,49,38,16,32,174,173,121,120,140,295,293,21054,3105465.0,20760,21608.75
2953,97,79,22,55,202,201,190,189,264,392,390,38380,7522480.0,37989,38220.0
2954,55,44,20,38,221,220,364,363,592,585,583,80444,23529870.0,79860,85263.75
2955,56,46,13,28,107,106,108,107,62,215,213,11556,1242270.0,11342,11448.75
2956,122,117,13,21,147,146,178,177,193,325,323,26166,4251975.0,25842,26243.75
2957,38,33,13,19,121,120,203,202,168,324,322,24563,3979206.0,24240,26082.0
2958,59,51,20,34,208,207,194,193,270,402,400,40352,8110752.0,39951,40200.0
296,55,47,12,25,113,112,136,135,103,249,247,15368,1913316.0,15120,15375.75
2960,93,76,30,60,315,314,502,501,2374,817,815,158130,64596105.0,157314,166463.75
2961,40,31,14,30,126,125,210,209,201,336,334,26460,4445280.0,26125,28056.0
2963,119,110,26,40,243,242,195,194,434,438,436,47385,10377315.0,46948,47742.0
2964,49,40,14,29,148,147,146,145,142,294,292,21608,3176376.0,21315,21462.0
2965,50,44,15,24,233,232,187,186,397,420,418,43571,9149910.0,43152,43890.0
2966,113,93,44,82,294,293,277,276,689,571,569,81438,23250549.0,80868,81224.75
2967,91,70,28,65,285,284,323,322,961,608,606,92055,27984720.0,91448,92112.0
2968,125,119,12,21,170,169,178,177,205,348,346,30260,5265240.0,29913,30102.0
2969,31,27,11,17,222,221,132,131,166,354,352,29304,5186808.0,28951,31152.0
297,64,54,22,40,168,167,187,186,213,355,353,31416,5576340.0,31062,31328.75
2970,86,71,20,48,218,217,244,243,332,462,460,53192,12287352.0,52731,53130.0
2971,104,91,29,52,238,237,195,194,323,433,431,46410,10047765.0,45978,46655.75
2972,355,341,19,45,405,404,377,376,2213,782,780,152685,59699835.0,151904,152490.0
2973,102,91,26,46,188,187,212,211,414,400,398,39856,7971200.0,39457,39800.0
2974,63,48,18,46,228,227,124,123,202,352,350,28272,4975872.0,27921,30800.0
2975,121,93,32,86,369,368,231,230,740,600,598,85239,25571700.0,84640,89700.0
2976,119,118,6,6,147,146,124,123,94,271,269,18228,2469894.0,17958,18224.75
2977,51,39,12,34,98,97,128,127,68,226,224,12544,1417472.0,12319,12656.0
2978,53,35,15,49,134,133,127,126,113,261,259,17018,2220849.0,16758,16899.75
2979,73,61,14,34,115,114,220,219,224,335,333,25300,4237750.0,24966,27888.75
298,60,50,16,34,149,148,155,154,129,304,302,23095,3510440.0,22792,22952.0
2980,88,78,27,45,150,149,216,215,227,366,364,32400,5929200.0,32035,33306.0
2981,66,51,25,50,226,225,148,147,281,374,372,33448,6254776.0,33075,34782.0
2982,101,80,30,70,184,183,267,266,468,451,449,49128,11078364.0,48678,50624.75
2983,32,26,11,19,185,184,105,104,114,290,288,19425,2816625.0,19136,20880.0
2984,45,36,15,30,97,96,161,160,89,258,256,15617,2014593.0,15360,16512.0
2985,68,62,19,28,318,317,137,136,388,455,453,43566,9911265.0,43112,51528.75
2986,58,51,14,26,124,123,124,123,88,248,246,15376,1906624.0,15129,15252.0
2987,52,37,9,35,89,88,147,146,75,236,234,13083,1543794.0,12848,13806.0
2988,58,52,19,28,152,151,164,163,136,316,314,24928,3938624.0,24613,24806.0
299,132,123,14,30,178,177,170,169,285,348,346,30260,5265240.0,29913,30102.0
2990,74,65,23,39,205,204,538,537,2292,743,741,110290,40972735.0,109548,137640.75
2991,68,54,22,48,183,182,168,167,215,351,349,30744,5395572.0,30394,30624.75
2992,63,54,23,39,244,243,238,237,516,482,480,58072,13995352.0,57591,57840.0
2993,57,47,20,37,350,349,197,196,827,547,545,68950,18857825.0,68404,74528.75
2994,80,69,25,44,226,225,390,389,742,616,614,88140,27147120.0,87525,94556.0
2995,52,45,14,26,216,215,91,90,141,307,305,19656,3017196.0,19350,23408.75
2996,33,28,14,22,116,115,195,194,152,311,309,22620,3517410.0,22310,24024.75
2997,37,35,8,9,167,166,277,276,554,444,442,46259,10269498.0,45816,49062.0
2998,149,125,40,86,329,328,270,269,1075,599,597,88830,26604585.0,88232,89400.75
2999,55,44,18,38,114,113,122,121,72,236,234,13908,1641144.0,13673,13806.0
3,77,61,20,46,203,202,325,324,652,528,526,65975,17417400.0,65448,69432.0
3000,73,62,22,42,203,202,164,163,211,367,365,33292,6109082.0,32926,33488.75
3001,67,53,23,49,293,292,334,333,822,627,625,97862,30679737.0,97236,97968.75
3002,36,31,11,18,221,220,544,543,1012,765,763,120224,45985680.0,119460,145923.75
3003,36,32,14,20,127,126,182,181,152,309,307,23114,3571113.0,22806,23715.75
3004,76,68,21,35,226,225,136,135,164,362,360,30736,5563216.0,30375,32580.0
3005,18,17,5,5,96,95,210,209,114,306,304,20160,3084480.0,19855,23256.0
3006,52,40,16,36,173,172,131,130,134,304,302,22663,3444776.0,22360,22952.0
3007,51,35,19,47,232,231,325,324,711,557,555,75400,20998900.0,74844,77283.75
3009,103,88,24,51,210,209,194,193,388,404,402,40740,8229480.0,40337,40602.0
301,50,40,16,31,132,131,127,126,111,259,257,16764,2170938.0,16506,16640.75
3010,131,100,46,105,411,410,283,282,1268,694,692,116313,40360611.0,115620,120062.0
3011,28,23,7,15,206,205,82,81,151,288,286,16892,2432448.0,16605,20592.0
3012,51,41,17,30,127,126,149,148,103,276,274,18923,2611374.0,18648,18906.0
3013,40,37,13,17,128,127,177,176,143,305,303,22656,3455040.0,22352,23103.75
3014,61,52,19,34,158,157,147,146,131,305,303,23226,3541965.0,22922,23103.75
3015,66,56,23,38,217,216,211,210,304,428,426,45787,9798418.0,45360,45582.0
3016,38,32,13,22,99,98,113,112,59,212,210,11187,1185822.0,10976,11130.0
3017,74,63,22,41,163,162,246,245,296,409,407,40098,8200041.0,39690,41615.75
3018,115,100,26,54,281,280,225,224,458,506,504,63225,15995925.0,62720,63756.0
3019,66,55,16,36,181,180,109,108,149,290,288,19729,2860705.0,19440,20880.0
3020,48,42,10,19,170,169,115,114,151,285,283,19550,2785875.0,19266,20163.75
3021,20,19,5,5,189,188,120,119,116,309,307,22680,3504060.0,22372,23715.75
3023,59,51,17,30,135,134,93,92,47,228,226,12555,1431270.0,12328,12882.0
3024,103,85,31,65,432,431,230,229,882,662,660,99360,32888160.0,98699,109230.0
3025,41,37,11,17,107,106,150,149,78,257,255,16050,2062425.0,15794,16383.75
3026,55,50,14,21,146,145,121,120,99,267,265,17666,2358411.0,17400,17688.75
3027,58,43,11,39,95,94,96,95,49,191,189,9120,870960.0,8930,9024.75
3028,91,78,22,45,200,199,298,297,434,498,496,59600,14840400.0,59103,61752.0
3029,21,19,6,8,254,253,180,179,397,434,432,45720,9921240.0,45287,46872.0
303,79,46,24,79,514,513,450,449,4306,964,962,231300,111486600.0,230337,231842.0
3030,67,49,24,56,119,118,192,191,178,311,309,22848,3552864.0,22538,24024.75
3031,61,50,14,27,179,178,265,264,344,444,442,47435,10530570.0,46992,49062.0
3033,49,41,12,26,162,161,330,329,558,492,490,53460,13151160.0,52969,60270.0
3034,42,37,9,17,102,101,100,99,45,202,200,10200,1030200.0,9999,10100.0
3035,67,55,22,43,120,119,234,233,198,354,352,28080,4970160.0,27727,31152.0
3036,56,44,17,39,158,157,270,269,343,428,426,42660,9129240.0,42233,45582.0
3037,37,28,12,27,136,135,171,170,184,307,305,23256,3569796.0,22950,23408.75
3038,52,42,17,34,104,103,121,120,71,225,223,12584,1415700.0,12360,12543.75
3039,42,36,13,22,149,148,126,125,95,275,273,18774,2581425.0,18500,18768.75
304,38,28,12,26,290,289,224,223,501,514,512,64960,16694720.0,64447,65792.0
3040,63,55,25,39,517,516,165,164,669,682,680,85305,29089005.0,84624,115940.0
3041,53,46,13,25,154,153,223,222,221,377,375,34342,6473467.0,33966,35343.75
3042,76,68,21,35,178,177,180,179,238,358,356,32040,5735160.0,31683,31862.0
3043,55,52,12,16,178,177,91,90,94,269,267,16198,2178631.0,15930,17955.75
3044,103,84,23,56,237,236,229,228,612,466,464,54273,12645609.0,53808,54056.0
3046,178,173,12,20,193,192,193,192,265,386,384,37249,7189057.0,36864,37056.0
3047,67,61,23,33,123,122,167,166,122,290,288,20541,2978445.0,20252,20880.0
3048,45,37,15,29,173,172,140,139,161,313,311,24220,3790430.0,23908,24335.75
3049,53,48,12,20,79,78,126,125,36,205,203,9954,1020285.0,9750,10403.75
305,40,37,12,16,84,83,121,120,71,205,203,10164,1041810.0,9960,10403.75
3050,72,61,26,46,186,185,391,390,625,577,575,72726,20981451.0,72150,82943.75
3051,62,50,22,44,205,204,182,181,231,387,385,37310,7219485.0,36924,37248.75
3052,66,54,25,46,258,257,437,436,1440,695,693,112746,39179235.0,112052,120408.75
3053,146,120,52,101,506,505,484,483,4911,990,988,244904,121227480.0,243915,244530.0
3055,52,51,7,7,98,97,103,102,37,201,199,10094,1014447.0,9894,9999.75
3056,112,90,40,82,323,322,201,200,500,524,522,64923,17009826.0,64400,68382.0
3057,118,110,28,42,172,171,211,210,310,383,381,36292,6949918.0,35910,36480.75
3058,126,92,33,94,304,303,310,309,763,614,612,94240,28931680.0,93627,93942.0
3059,87,74,28,52,173,172,351,350,465,524,522,60723,15909426.0,60200,68382.0
306,83,65,29,63,159,158,402,401,584,561,559,63918,17928999.0,63358,78399.75
3060,49,39,14,32,224,223,120,119,172,344,342,26880,4623360.0,26537,29412.0
3061,64,57,18,29,147,146,148,147,113,295,293,21756,3209010.0,21462,21608.75
3062,55,50,14,20,117,116,129,128,74,246,244,15093,1856439.0,14848,15006.0
3063,113,108,12,19,239,238,178,177,331,417,415,42542,8870007.0,42126,43263.75
3064,60,54,18,28,235,234,137,136,195,372,370,32195,5988270.0,31824,34410.0
3065,101,84,27,59,270,269,185,184,338,455,453,49950,11363625.0,49496,51528.75
3066,46,33,12,25,117,116,207,206,199,324,322,24219,3923478.0,23896,26082.0
3067,69,61,21,32,273,272,216,215,729,489,487,58968,14417676.0,58480,59535.75
3068,74,53,26,64,238,237,222,221,392,460,458,52836,12152280.0,52377,52670.0
3069,55,44,17,35,202,201,161,160,212,363,361,32522,5902743.0,32160,32760.75
307,42,36,14,24,117,116,108,107,65,225,223,12636,1421550.0,12412,12543.75
3070,65,57,22,36,157,156,173,172,135,330,328,27161,4481565.0,26832,27060.0
3071,91,76,18,44,324,323,431,430,3469,755,753,139644,52715610.0,138890,142128.75
3072,237,235,17,19,295,294,261,260,894,556,554,76995,21404610.0,76440,77006.0
3073,95,77,36,70,253,252,277,276,649,530,528,70081,18571465.0,69552,69960.0
3074,72,57,23,51,283,282,197,196,528,480,478,55751,13380240.0,55272,57360.0
3075,86,72,27,52,230,229,159,158,242,389,387,36570,7112865.0,36182,37635.75
3076,114,113,6,6,170,169,147,146,133,317,315,24990,3960915.0,24674,24963.75
3077,257,256,10,10,267,266,267,266,563,534,532,71289,19034163.0,70756,71022.0
3078,52,42,19,35,312,311,249,248,476,561,559,77688,21791484.0,77128,78399.75
3079,28,27,6,6,88,87,90,89,45,178,176,7920,704880.0,7743,7832.0
308,50,47,14,18,124,123,161,160,112,285,283,19964,2844870.0,19680,20163.75
3080,48,41,15,24,233,232,158,157,282,391,389,36814,7197137.0,36424,38024.75
3081,61,49,20,41,207,206,494,493,1122,701,699,102258,35841429.0,101558,122499.75
3082,77,58,28,62,208,207,147,146,237,355,353,30576,5427240.0,30222,31328.75
3083,39,34,12,17,243,242,116,115,204,359,357,28188,5059746.0,27830,32040.75
3084,55,48,18,30,101,100,246,245,171,347,345,24846,4310781.0,24500,29928.75
3085,58,50,17,31,151,150,188,187,239,339,337,28388,4811766.0,28050,28560.75
3086,33,29,9,12,84,83,80,79,24,164,162,6720,551040.0,6557,6642.0
3087,82,67,23,49,155,154,141,140,151,296,294,21855,3234540.0,21560,21756.0
3088,46,41,14,20,242,241,103,102,170,345,343,24926,4299735.0,24582,29583.75
309,56,47,14,28,143,142,212,211,213,355,353,30316,5381090.0,29962,31328.75
3090,55,45,22,39,111,110,144,143,107,255,253,15984,2037960.0,15730,16128.75
3091,65,56,21,36,226,225,153,152,239,379,377,34578,6552531.0,34200,35720.75
3092,34,25,6,15,129,128,100,99,99,229,227,12900,1477050.0,12672,12995.75
3093,113,96,31,63,268,267,213,212,335,481,479,57084,13728702.0,56604,57599.75
3094,61,57,13,18,106,105,141,140,71,247,245,14946,1845831.0,14700,15128.75
3095,53,39,18,44,168,167,153,152,180,321,319,25704,4125492.0,25384,25599.75
3096,49,42,13,23,159,158,84,83,60,243,241,13356,1622754.0,13114,14640.75
3097,28,19,5,21,88,87,75,74,38,163,161,6600,537900.0,6438,6560.75
3098,61,48,20,44,268,267,128,127,255,396,394,34304,6792192.0,33909,39006.0
3099,72,66,26,36,132,131,136,135,88,268,266,17952,2405568.0,17685,17822.0
31,43,25,9,26,129,128,153,152,138,282,280,19737,2782917.0,19456,19740.0
310,106,101,11,19,193,192,178,177,251,371,369,34354,6372667.0,33984,34224.75
3100,60,52,14,26,154,153,144,143,148,298,296,22176,3304224.0,21879,22052.0
3101,38,30,8,17,131,130,95,94,66,226,224,12445,1406285.0,12220,12656.0
3103,47,39,16,29,98,97,201,200,104,299,297,19698,2944851.0,19400,22200.75
3104,65,61,20,26,126,125,134,133,107,260,258,16884,2194920.0,16625,16770.0
3105,85,75,26,44,281,280,208,207,501,489,487,58448,14290536.0,57960,59535.75
3106,60,53,12,24,120,119,84,83,44,204,202,10080,1028160.0,9877,10302.0
3107,26,21,8,16,205,204,133,132,188,338,336,27265,4607785.0,26928,28392.0
3108,32,28,10,15,127,126,132,131,100,259,257,16764,2170938.0,16506,16640.75
3109,45,35,13,30,141,140,127,126,86,268,266,17907,2399538.0,17640,17822.0
311,62,53,19,35,243,242,244,243,457,487,485,59292,14437602.0,58806,59048.75
3110,58,49,21,36,135,134,120,119,84,255,253,16200,2065500.0,15946,16128.75
3111,82,77,23,31,156,155,117,116,98,273,271,18252,2491398.0,17980,18495.75
3112,45,36,13,28,117,116,177,176,131,294,292,20709,3044223.0,20416,21462.0
3113,28,22,6,13,167,166,105,104,169,272,270,17535,2384760.0,17264,18360.0
3115,60,46,19,44,128,127,154,153,147,282,280,19712,2779392.0,19431,19740.0
3116,51,46,11,19,129,128,84,83,61,213,211,10836,1154034.0,10624,11235.75
3117,45,37,10,19,101,100,132,131,65,233,231,13332,1553178.0,13100,13455.75
3118,46,40,13,21,146,145,141,140,90,287,285,20586,2954091.0,20300,20448.75
3119,134,109,46,93,401,400,454,453,2341,855,853,182054,77828085.0,181200,182328.75
312,82,73,20,36,156,155,191,190,190,347,345,29796,5169606.0,29450,29928.75
3120,257,256,10,10,267,266,267,266,597,534,532,71289,19034163.0,70756,71022.0
3121,69,60,21,37,154,153,146,145,161,300,298,22484,3372600.0,22185,22350.0
3122,22,19,7,10,98,97,138,137,68,236,234,13524,1595832.0,13289,13806.0
3123,47,39,12,25,84,83,137,136,96,221,219,11508,1271634.0,11288,12099.75
3124,82,67,33,61,302,301,252,251,546,554,552,76104,21080808.0,75551,76452.0
3125,51,36,12,29,116,115,87,86,56,203,201,10092,1024338.0,9890,10200.75
3126,141,122,33,69,296,295,317,316,1323,613,611,93832,28759508.0,93220,93635.75
3127,117,89,42,93,298,297,415,414,1056,713,711,123670,44088355.0,122958,126735.75
3128,166,119,50,140,514,513,474,473,7573,988,986,243636,120356184.0,242649,243542.0
3129,25,21,8,13,196,195,111,110,146,307,305,21756,3339546.0,21450,23408.75
313,17,16,3,3,146,145,71,70,53,217,215,10366,1124711.0,10150,11663.75
3130,41,38,13,15,167,166,172,171,310,339,337,28724,4868718.0,28386,28560.75
3131,42,29,12,25,97,96,165,164,108,262,260,16005,2096655.0,15744,17030.0
3132,47,36,18,34,210,209,107,106,154,317,315,22470,3561495.0,22154,24963.75
3133,124,108,38,68,285,284,221,220,498,506,504,62985,15935205.0,62480,63756.0
3134,73,61,14,36,214,213,426,425,909,640,638,91164,29172480.0,90525,102080.0
3136,109,91,34,66,263,262,265,264,664,528,526,69695,18399480.0,69168,69432.0
3137,69,54,28,54,338,337,381,380,1257,719,717,128778,46295691.0,128060,128880.75
3138,50,46,15,21,172,171,193,192,169,365,363,33196,6058270.0,32832,33123.75
3139,81,69,24,44,130,129,150,149,108,280,278,19500,2730000.0,19221,19460.0
3140,76,63,17,36,164,163,177,176,182,341,339,29028,4949274.0,28688,28899.75
3141,32,22,7,18,168,167,103,102,100,271,269,17304,2344692.0,17034,18224.75
3142,65,50,19,45,197,196,176,175,215,373,371,34672,6466328.0,34300,34595.75
3143,91,80,18,38,148,147,142,141,126,290,288,21016,3047320.0,20727,20880.0
3144,42,32,14,25,146,145,126,125,113,272,270,18396,2501856.0,18125,18360.0
3145,49,44,16,24,96,95,191,190,118,287,285,18336,2631216.0,18050,20448.75
3146,53,44,16,29,109,108,173,172,127,282,280,18857,2658837.0,18576,19740.0
3147,53,36,18,49,279,278,206,205,537,485,483,57474,13937445.0,56990,58563.75
3148,48,39,14,30,102,101,75,74,28,177,175,7650,677025.0,7474,7743.75
3149,35,31,8,13,230,229,208,207,316,438,436,47840,10476960.0,47403,47742.0
315,118,108,26,44,160,159,241,240,212,401,399,38560,7731280.0,38160,39999.75
3151,55,50,15,22,148,147,165,164,199,313,311,24420,3821730.0,24108,24335.75
3152,61,53,20,33,115,114,108,107,82,223,221,12420,1384830.0,12198,12320.75
3153,70,57,19,42,151,150,235,234,270,386,384,35485,6848605.0,35100,37056.0
3154,103,88,34,62,202,201,210,209,230,412,410,42420,8738520.0,42009,42230.0
3155,26,25,8,8,93,92,125,124,55,218,216,11625,1267125.0,11408,11772.0
3156,59,55,11,16,143,142,175,174,120,318,316,25025,3978975.0,24708,25122.0
3157,66,57,22,37,141,140,137,136,85,278,276,19317,2685063.0,19040,19182.0
3158,53,48,21,29,208,207,258,257,365,466,464,53664,12503712.0,53199,54056.0
3159,47,41,19,29,248,247,124,123,230,372,370,30752,5719872.0,30381,34410.0
316,59,40,19,51,234,233,162,161,277,396,394,37908,7505784.0,37513,39006.0
3160,56,55,16,16,190,189,323,322,760,513,511,61370,15741405.0,60858,65535.75
3161,20,18,6,8,185,184,101,100,109,286,284,18685,2671955.0,18400,20306.0
3162,214,172,66,147,476,475,500,499,5191,976,974,238000,116144000.0,237025,237656.0
3163,64,51,21,42,144,143,190,189,210,334,332,27360,4569120.0,27027,27722.0
3164,66,46,22,55,247,246,240,239,752,487,485,59280,14434680.0,58794,59048.75
3165,85,83,23,25,147,146,113,112,98,260,258,16611,2159430.0,16352,16770.0
3166,42,36,11,20,122,121,84,83,37,206,204,10248,1055544.0,10043,10506.0
3167,27,23,8,12,180,179,143,142,216,323,321,25740,4157010.0,25418,25920.75
3168,174,166,27,41,326,325,406,405,6482,732,730,132356,48442296.0,131625,133590.0
3169,54,46,14,28,141,140,178,177,157,319,317,25098,4003131.0,24780,25280.75
317,109,84,30,77,344,343,319,318,1015,663,661,109736,36377484.0,109074,109560.75
3170,42,35,12,23,106,105,154,153,91,260,258,16324,2122120.0,16065,16770.0
3171,50,41,20,36,208,207,186,185,317,394,392,38688,7621536.0,38295,38612.0
3172,39,31,9,22,275,274,121,120,322,396,394,33275,6588450.0,32880,39006.0
3174,60,47,18,42,148,147,146,145,142,294,292,21608,3176376.0,21315,21462.0
3175,49,34,14,42,107,106,102,101,64,209,207,10914,1140513.0,10706,10815.75
3176,70,62,21,34,150,149,171,170,134,321,319,25650,4116825.0,25330,25599.75
3177,36,28,13,25,112,111,146,145,98,258,256,16352,2109408.0,16095,16512.0
3178,94,81,24,47,311,310,302,301,1396,613,611,93922,28787093.0,93310,93635.75
3179,89,71,26,59,181,180,164,163,178,345,343,29684,5120490.0,29340,29583.75
318,27,25,7,8,164,163,100,99,108,264,262,16400,2164800.0,16137,17292.0
3181,36,24,8,24,142,141,171,170,156,313,311,24282,3800133.0,23970,24335.75
3182,32,18,9,33,148,147,111,110,99,259,257,16428,2127426.0,16170,16640.75
3183,56,50,19,28,223,222,259,258,542,482,480,57757,13919437.0,57276,57840.0
3184,43,33,14,30,140,139,290,289,308,430,428,40600,8729000.0,40171,46010.0
3185,71,51,21,59,240,239,147,146,221,387,385,35280,6826680.0,34894,37248.75
3186,65,51,16,40,91,90,154,153,90,245,243,14014,1716715.0,13770,14883.75
3187,51,47,16,22,297,296,153,152,322,450,448,45441,10224225.0,44992,50400.0
3188,91,75,23,51,225,224,227,226,491,452,450,51075,11542950.0,50624,50850.0
3189,29,26,8,12,98,97,148,147,73,246,244,14504,1783992.0,14259,15006.0
319,49,45,12,18,149,148,100,99,128,249,247,14900,1855050.0,14652,15375.75
3190,44,38,10,20,142,141,105,104,101,247,245,14910,1841385.0,14664,15128.75
3191,62,57,16,24,101,100,189,188,123,290,288,19089,2767905.0,18800,20880.0
3192,64,50,22,46,437,436,523,522,3796,960,958,228551,109704480.0,227592,229920.0
3193,48,41,12,23,89,88,118,117,55,207,205,10502,1086957.0,10296,10608.75
3194,85,71,22,42,263,262,160,159,265,423,421,42080,8899920.0,41658,44520.75
3195,75,61,25,51,215,214,141,140,184,356,354,30315,5396070.0,29960,31506.0
3197,43,38,12,17,122,121,87,86,53,209,207,10614,1109163.0,10406,10815.75
3198,79,63,26,54,205,204,153,152,250,358,356,31365,5614335.0,31008,31862.0
3199,78,58,30,65,242,241,203,202,352,445,443,49126,10930535.0,48682,49283.75
32,33,22,6,22,112,111,84,83,43,196,194,9408,921984.0,9213,9506.0
320,75,63,28,50,161,160,212,211,228,373,371,34132,6365618.0,33760,34595.75
3200,42,36,9,17,86,85,89,88,31,175,173,7654,669725.0,7480,7568.75
3202,255,254,9,9,267,266,267,266,606,534,532,71289,19034163.0,70756,71022.0
3203,53,46,14,22,130,129,178,177,138,308,306,23140,3563560.0,22833,23562.0
3204,20,19,6,6,134,133,92,91,83,226,224,12328,1393064.0,12103,12656.0
3205,36,29,9,16,99,98,158,157,113,257,255,15642,2009997.0,15386,16383.75
3206,36,31,11,19,175,174,119,118,90,294,292,20825,3061275.0,20532,21462.0
3207,88,71,27,58,262,261,263,262,556,525,523,68906,18087825.0,68382,68643.75
3208,102,79,36,80,247,246,459,458,1432,706,704,113373,40020669.0,112668,124256.0
3209,28,25,6,8,101,100,119,118,60,220,218,12019,1322090.0,11800,11990.0
321,40,31,7,20,140,139,176,175,191,316,314,24640,3893120.0,24325,24806.0
3210,257,256,11,11,267,266,271,270,579,538,536,72357,19464033.0,71820,72092.0
3211,28,24,10,15,99,98,191,190,101,290,288,18909,2741805.0,18620,20880.0
3212,113,108,12,19,178,177,216,215,300,394,392,38448,7574256.0,38055,38612.0
3213,57,45,19,41,267,266,225,224,557,492,490,60075,14778450.0,59584,60270.0
3214,24,18,6,14,346,345,353,352,1309,699,697,122138,42687231.0,121440,121800.75
3215,161,127,50,112,376,375,537,536,3277,913,911,201912,92172828.0,201000,207935.75
3216,257,256,11,11,271,270,267,266,596,538,536,72357,19464033.0,71820,72092.0
3217,47,35,18,40,144,143,136,135,106,280,278,19584,2741760.0,19305,19460.0
3219,49,44,14,22,141,140,93,92,91,234,232,13113,1534221.0,12880,13572.0
322,53,44,16,28,125,124,189,188,139,314,312,23625,3709125.0,23312,24492.0
3220,125,120,23,31,180,179,209,208,273,389,387,37620,7317090.0,37232,37635.75
3221,44,33,15,34,90,89,109,108,50,199,197,9810,976095.0,9612,9800.75
3222,111,94,29,61,279,278,302,301,676,581,579,84258,24476949.0,83678,84099.75
3223,46,41,13,21,153,152,74,73,51,227,225,11322,1285047.0,11096,12768.75
3225,93,82,21,41,162,161,152,151,172,314,312,24624,3865968.0,24311,24492.0
3226,61,56,17,25,213,212,196,195,235,409,407,41748,8537466.0,41340,41615.75
3227,64,52,21,43,175,174,96,95,92,271,269,16800,2276400.0,16530,18224.75
3228,57,42,15,41,175,174,198,197,381,373,371,34650,6462225.0,34278,34595.75
323,81,63,27,59,218,217,139,138,351,357,355,30302,5408907.0,29946,31683.75
3230,32,24,8,19,102,101,346,345,321,448,446,35292,7905408.0,34845,49952.0
3231,102,84,31,64,287,286,421,420,1433,708,706,120827,42772758.0,120120,124962.0
3232,26,23,8,11,177,176,102,101,93,279,277,18054,2518533.0,17776,19320.75
3233,72,55,21,53,134,133,125,124,90,259,257,16750,2169125.0,16492,16640.75
3234,71,53,18,51,171,170,257,256,320,428,426,43947,9404658.0,43520,45582.0
3235,77,57,20,55,208,207,178,177,337,386,384,37024,7145632.0,36639,37056.0
3237,53,48,17,22,241,240,188,187,404,429,427,45308,9718566.0,44880,45795.75
3238,99,74,27,72,442,441,526,525,7288,968,966,232492,112526128.0,231525,233772.0
3239,286,261,45,93,372,371,436,435,3695,808,806,162192,65525568.0,161385,162812.0
324,80,67,20,44,146,145,182,181,208,328,326,26572,4357808.0,26245,26732.0
3240,101,80,29,68,218,217,199,198,381,417,415,43382,9045147.0,42966,43263.75
3241,67,59,18,32,127,126,211,210,205,338,336,26797,4528693.0,26460,28392.0
3242,81,65,25,53,173,172,198,197,369,371,369,34254,6354117.0,33884,34224.75
3243,86,76,17,33,270,269,129,128,286,399,397,34830,6948585.0,34432,39600.75
3244,62,54,16,30,179,178,144,143,153,323,321,25776,4162824.0,25454,25920.75
3245,51,39,14,36,244,243,253,252,531,497,495,61732,15340402.0,61236,61503.75
3246,56,45,17,36,133,132,306,305,356,439,437,40698,8933211.0,40260,47960.75
3248,76,55,22,62,230,229,144,143,225,374,372,33120,6193440.0,32747,34782.0
3249,101,87,26,51,206,205,236,235,362,442,440,48616,10744136.0,48175,48620.0
325,70,64,23,33,258,257,164,163,273,422,420,42312,8927832.0,41891,44310.0
3250,67,55,18,39,178,177,249,248,391,427,425,44322,9462747.0,43896,45368.75
3251,48,37,15,33,128,127,132,131,98,260,258,16896,2196480.0,16637,16770.0
3252,35,30,10,17,168,167,94,93,85,262,260,15792,2068752.0,15531,17030.0
3253,56,52,16,22,312,311,203,202,610,515,513,63336,16309020.0,62822,66048.75
3254,43,37,14,20,132,131,147,146,124,279,277,19404,2706858.0,19126,19320.75
3255,40,31,11,27,100,99,134,133,65,234,232,13400,1567800.0,13167,13572.0
3256,57,50,16,28,98,97,152,151,70,250,248,14896,1862000.0,14647,15500.0
3257,69,60,25,40,141,140,121,120,108,262,260,17061,2234991.0,16800,17030.0
3258,78,63,29,56,229,228,225,224,348,454,452,51525,11696175.0,51072,51302.0
3259,57,53,17,23,109,108,169,168,92,278,276,18421,2560519.0,18144,19182.0
326,53,45,18,32,289,288,334,333,826,623,621,96526,30067849.0,95904,96720.75
3260,47,43,9,15,143,142,104,103,67,247,245,14872,1836692.0,14626,15128.75
3261,83,68,25,51,128,127,173,172,175,301,299,22144,3332672.0,21844,22499.75
3262,29,23,11,20,171,170,168,167,215,339,337,28728,4869396.0,28390,28560.75
3263,94,79,33,61,298,297,293,292,623,591,589,87314,25801287.0,86724,87024.75
3264,88,75,29,53,310,309,206,205,722,516,514,63860,16475880.0,63345,66306.0
3265,97,76,28,67,401,400,217,216,805,618,616,87017,26888253.0,86400,95172.0
3266,68,58,26,42,524,523,324,323,2186,848,846,169776,71985024.0,168929,179352.0
3267,68,54,17,41,144,143,182,181,170,326,324,26208,4271904.0,25883,26406.0
3268,77,68,25,40,227,226,197,196,254,424,422,44719,9480428.0,44296,44732.0
3269,85,74,26,46,287,286,174,173,420,461,459,49938,11510709.0,49478,52899.75
327,33,29,10,16,267,266,169,168,494,436,434,45123,9836814.0,44688,47306.0
3270,42,36,12,22,144,143,153,152,113,297,295,22032,3271752.0,21736,21903.75
3271,94,64,31,88,277,276,285,284,770,562,560,78945,22183545.0,78384,78680.0
3272,53,47,15,23,194,193,210,209,304,404,402,40740,8229480.0,40337,40602.0
3273,49,41,15,29,169,168,107,106,113,276,274,18083,2495454.0,17808,18906.0
3275,117,94,34,77,318,317,424,423,1484,742,740,134832,50022672.0,134091,137270.0
3276,24,20,7,13,151,150,168,167,197,319,317,25368,4046196.0,25050,25280.75
3277,67,53,26,52,125,124,181,180,150,306,304,22625,3461625.0,22320,23256.0
3278,45,43,14,16,151,150,103,102,88,254,252,15553,1975231.0,15300,16002.0
328,53,43,16,28,86,85,168,167,85,254,252,14448,1834896.0,14195,16002.0
3280,44,33,12,32,151,150,126,125,123,277,275,19026,2635101.0,18750,19043.75
3281,46,44,13,15,143,142,85,84,72,228,226,12155,1385670.0,11928,12882.0
3282,60,53,16,28,161,160,125,124,130,286,284,20125,2877875.0,19840,20306.0
3283,58,49,15,31,112,111,186,185,126,298,296,20832,3103968.0,20535,22052.0
3285,61,48,12,25,134,133,112,111,78,246,244,15008,1845984.0,14763,15006.0
3286,33,28,10,18,250,249,129,128,165,379,377,32250,6111375.0,31872,35720.75
3287,96,81,33,60,263,262,476,475,1938,739,737,125188,46256966.0,124450,136160.75
3288,66,48,27,57,423,422,272,271,1809,695,693,115056,39981960.0,114362,120408.75
329,102,76,28,77,216,215,267,266,621,483,481,57672,13927788.0,57190,58080.75
3290,60,52,19,31,136,135,94,93,65,230,228,12784,1470160.0,12555,13110.0
3291,46,43,11,14,185,184,112,111,106,297,295,20720,3076920.0,20424,21903.75
3292,42,36,13,20,150,149,189,188,211,339,337,28350,4805325.0,28012,28560.75
3293,32,29,6,9,114,113,174,173,106,288,286,19836,2856384.0,19549,20592.0
3294,107,103,11,17,216,215,178,177,292,394,392,38448,7574256.0,38055,38612.0
3295,40,30,12,27,128,127,132,131,115,260,258,16896,2196480.0,16637,16770.0
3296,140,139,7,7,147,146,147,146,173,294,292,21609,3176523.0,21316,21462.0
3297,171,170,7,7,178,177,178,177,180,356,354,31684,5639752.0,31329,31506.0
3298,52,42,12,26,103,102,90,89,45,193,191,9270,894555.0,9078,9215.75
3299,58,47,17,36,350,349,224,223,566,574,572,78400,22500800.0,77827,82082.0
33,150,109,56,135,377,376,403,402,1958,780,778,151931,59253090.0,151152,151710.0
330,70,59,20,39,152,151,209,208,268,361,359,31768,5734124.0,31408,32399.75
3300,95,94,3,3,308,307,147,146,344,455,453,45276,10300290.0,44822,51528.75
3301,113,108,12,19,178,177,262,261,423,440,438,46636,10259920.0,46197,48180.0
3302,56,45,21,39,207,206,107,106,152,314,312,22149,3477393.0,21836,24492.0
3303,151,121,47,105,460,459,320,319,2082,780,778,147200,57408000.0,146421,151710.0
3304,108,91,31,63,205,204,175,174,237,380,378,35875,6816250.0,35496,35910.0
3305,55,48,10,21,94,93,92,91,29,186,184,8648,804264.0,8463,8556.0
3306,44,39,12,18,104,103,92,91,58,196,194,9568,937664.0,9373,9506.0
3307,50,42,16,29,127,126,150,149,148,277,275,19050,2638425.0,18774,19043.75
3308,51,42,12,28,260,259,114,113,213,374,372,29640,5542680.0,29267,34782.0
3309,76,64,29,51,284,283,154,153,279,438,436,43736,9578184.0,43299,47742.0
331,42,26,11,28,194,193,203,202,391,397,395,39382,7817327.0,38986,39203.75
3310,78,56,19,60,192,191,209,208,385,401,399,40128,8045664.0,39728,39999.75
3311,49,42,15,24,237,236,168,167,265,405,403,39816,8062740.0,39412,40803.75
3312,50,38,7,28,123,122,105,104,75,228,226,12915,1472310.0,12688,12882.0
3313,25,23,8,10,190,189,364,363,561,554,552,69160,19157320.0,68607,76452.0
3314,80,69,26,46,267,266,207,206,399,474,472,55269,13098753.0,54796,55932.0
3315,38,34,10,15,138,137,136,135,164,274,272,18768,2571216.0,18495,18632.0
3316,110,98,24,44,170,169,177,176,212,347,345,30090,5220615.0,29744,29928.75
3317,41,37,11,16,89,88,140,139,74,229,227,12460,1426670.0,12232,12995.75
3318,52,49,19,23,155,154,129,128,110,284,282,19995,2839290.0,19712,20022.0
3319,62,52,18,36,184,183,146,145,243,330,328,26864,4432560.0,26535,27060.0
332,50,34,11,40,160,159,129,128,215,289,287,20640,2982480.0,20352,20735.75
3320,103,86,25,56,204,203,189,188,232,393,391,38556,7576254.0,38164,38415.75
3321,38,25,9,28,153,152,172,171,176,325,323,26316,4276350.0,25992,26243.75
3322,73,57,21,47,327,326,211,210,765,538,536,68997,18560193.0,68460,72092.0
3323,36,29,12,24,191,190,94,93,103,285,283,17954,2558445.0,17670,20163.75
3324,71,52,23,57,345,344,469,468,2150,814,812,161805,65854635.0,160992,165242.0
3325,66,57,21,35,138,137,148,147,147,286,284,20424,2920632.0,20139,20306.0
3326,58,53,13,21,186,185,179,178,188,365,363,33294,6076155.0,32930,33123.75
3327,61,54,25,37,121,120,227,226,176,348,346,27467,4779258.0,27120,30102.0
3328,148,124,51,97,345,344,451,450,1835,796,794,155595,61926810.0,154800,158006.0
3329,63,51,22,43,249,248,190,189,369,439,437,47310,10384545.0,46872,47960.75
333,77,56,20,60,129,128,161,160,160,290,288,20769,3011505.0,20480,20880.0
3330,56,40,22,52,177,176,191,190,248,368,366,33807,6220488.0,33440,33672.0
3331,58,42,11,41,147,146,158,157,204,305,303,23226,3541965.0,22922,23103.75
3332,86,73,31,54,265,264,194,193,419,459,457,51410,11798595.0,50952,52440.75
3333,60,52,15,29,163,162,297,296,556,460,458,48411,11134530.0,47952,52670.0
3334,57,39,15,48,232,231,412,411,1541,644,642,95584,30778048.0,94941,103362.0
3335,257,256,10,10,267,266,267,266,590,534,532,71289,19034163.0,70756,71022.0
3336,69,45,19,59,223,222,201,200,474,424,422,44823,9502476.0,44400,44732.0
3337,95,94,3,3,193,192,239,238,444,432,430,46127,9963432.0,45696,46440.0
3338,49,37,11,23,134,133,109,108,113,243,241,14606,1774629.0,14364,14640.75
3339,28,21,7,18,93,92,107,106,48,200,198,9951,995100.0,9752,9900.0
334,62,56,19,29,146,145,198,197,186,344,342,28908,4972176.0,28565,29412.0
3340,93,85,21,35,175,174,146,145,204,321,319,25550,4100775.0,25230,25599.75
3341,85,67,23,57,164,163,184,183,164,348,346,30176,5250624.0,29829,30102.0
3342,79,59,25,63,235,234,223,222,376,458,456,52405,12000745.0,51948,52212.0
3343,44,39,10,18,119,118,93,92,59,212,210,11067,1173102.0,10856,11130.0
3344,64,43,17,55,219,218,138,137,262,357,355,30222,5394627.0,29866,31683.75
3345,68,55,16,40,120,119,157,156,108,277,275,18840,2609340.0,18564,19043.75
3346,51,38,16,34,208,207,278,277,513,486,484,57824,14051232.0,57339,58806.0
3347,64,56,20,32,132,131,144,143,151,276,274,19008,2623104.0,18733,18906.0
3348,80,65,18,46,134,133,245,244,240,379,377,32830,6221285.0,32452,35720.75
3349,101,85,33,61,240,239,213,212,440,453,451,51120,11578680.0,50668,51075.75
335,70,55,24,44,178,177,198,197,350,376,374,35244,6625872.0,34869,35156.0
3350,61,44,14,46,129,128,187,186,177,316,314,24123,3811434.0,23808,24806.0
3352,72,59,21,44,207,206,113,112,118,320,318,23391,3742560.0,23072,25440.0
3353,79,63,21,50,212,211,266,265,409,478,476,56392,13477688.0,55915,56882.0
3354,108,82,26,73,267,266,320,319,816,587,585,85440,25076640.0,84854,85848.75
3355,132,105,41,92,482,481,354,353,2081,836,834,170628,71322504.0,169793,174306.0
3356,108,84,33,78,339,338,364,363,1349,703,701,123396,43373694.0,122694,123200.75
3357,149,117,43,105,287,286,368,367,923,655,653,105616,34589240.0,104962,106928.75
3358,112,92,33,70,248,247,253,252,498,501,499,62744,15717372.0,62244,62499.75
3359,104,85,31,61,287,286,233,232,588,520,518,66871,17386460.0,66352,67340.0
336,63,55,19,33,99,98,175,174,98,274,272,17325,2373525.0,17052,18632.0
3361,72,60,19,41,154,153,240,239,259,394,392,36960,7281120.0,36567,38612.0
3362,124,118,13,23,178,177,147,146,192,325,323,26166,4251975.0,25842,26243.75
3363,56,50,22,32,263,262,192,191,344,455,453,50496,11487840.0,50042,51528.75
3364,80,64,27,57,207,206,201,200,325,408,406,41607,8487828.0,41200,41412.0
3365,46,39,17,28,110,109,163,162,106,273,271,17930,2447445.0,17658,18495.75
3366,85,70,26,53,196,195,246,245,383,442,440,48216,10655736.0,47775,48620.0
3367,56,50,18,27,184,183,102,101,101,286,284,18768,2683824.0,18483,20306.0
3368,38,31,11,19,147,146,111,110,91,258,256,16317,2104893.0,16060,16512.0
3369,59,53,17,26,180,179,143,142,211,323,321,25740,4157010.0,25418,25920.75
337,49,42,15,27,163,162,138,137,137,301,299,22494,3385347.0,22194,22499.75
3370,90,72,28,62,216,215,146,145,328,362,360,31536,5708016.0,31175,32580.0
3372,47,36,15,32,214,213,144,143,234,358,356,30816,5516064.0,30459,31862.0
3373,257,256,10,10,267,266,267,266,582,534,532,71289,19034163.0,70756,71022.0
3374,85,63,28,70,164,163,170,169,205,334,332,27880,4655960.0,27547,27722.0
3375,33,29,8,14,119,118,127,126,74,246,244,15113,1858899.0,14868,15006.0
3376,111,89,37,76,255,254,265,264,591,520,518,67575,17569500.0,67056,67340.0
3377,108,96,34,55,291,290,307,306,800,598,596,89337,26711763.0,88740,89102.0
3378,77,61,23,53,154,153,219,218,215,373,371,33726,6289899.0,33354,34595.75
3379,66,60,18,28,175,174,152,151,163,327,325,26600,4349100.0,26274,26568.75
338,79,63,26,54,170,169,154,153,238,324,322,26180,4241160.0,25857,26082.0
3381,40,32,15,23,146,145,179,178,219,325,323,26134,4246775.0,25810,26243.75
3382,58,46,17,34,212,211,187,186,329,399,397,39644,7908978.0,39246,39600.75
3383,107,86,38,78,277,276,328,327,806,605,603,90856,27483940.0,90252,91203.75
3384,51,42,17,33,332,331,157,156,475,489,487,52124,12744318.0,51636,59535.75
3385,75,62,22,44,203,202,124,123,261,327,325,25172,4115622.0,24846,26568.75
3386,36,31,9,16,135,134,168,167,139,303,301,22680,3436020.0,22378,22800.75
3387,101,90,30,50,228,227,194,193,327,422,420,44232,9332952.0,43811,44310.0
3388,27,24,8,11,108,107,115,114,54,223,221,12420,1384830.0,12198,12320.75
3389,50,38,17,39,151,150,105,104,115,256,254,15855,2029440.0,15600,16256.0
339,42,32,17,32,190,189,128,127,157,318,316,24320,3866880.0,24003,25122.0
3390,115,98,26,57,200,199,175,174,191,375,373,35000,6562500.0,34626,34968.75
3391,68,61,13,20,161,160,104,103,78,265,263,16744,2218580.0,16480,17423.75
3392,89,76,24,48,219,218,165,164,207,384,382,36135,6937920.0,35752,36672.0
3393,64,58,19,29,150,149,190,189,178,340,338,28500,4845000.0,28161,28730.0
3394,93,81,26,48,233,232,304,303,670,537,535,70832,19018392.0,70296,71823.75
3395,80,69,23,41,130,129,145,144,98,275,273,18850,2591875.0,18576,18768.75
3397,80,66,30,55,432,431,323,322,1608,755,753,139536,52674840.0,138782,142128.75
3398,42,38,10,16,106,105,110,109,46,216,214,11660,1259280.0,11445,11556.0
3399,42,31,16,35,96,95,121,120,83,217,215,11616,1260336.0,11400,11663.75
34,64,53,10,30,191,190,95,94,168,286,284,18145,2594735.0,17860,20306.0
340,58,50,20,34,114,113,142,141,85,256,254,16188,2072064.0,15933,16256.0
3400,105,86,40,76,190,189,282,281,412,472,470,53580,12644880.0,53109,55460.0
3401,21,20,6,6,369,368,236,235,924,605,603,87084,26342910.0,86480,91203.75
3402,50,42,12,25,125,124,113,112,73,238,236,14125,1680875.0,13888,14042.0
3403,75,58,20,42,180,179,202,201,275,382,380,36360,6944760.0,35979,36290.0
3404,112,93,40,75,333,332,229,228,462,562,560,76257,21428217.0,75696,78680.0
3405,73,63,19,35,120,119,171,170,197,291,289,20520,2985660.0,20230,21024.75
3406,126,100,42,92,416,415,480,479,3225,896,894,199680,89456640.0,198785,200256.0
3407,112,93,35,71,267,266,380,379,970,647,645,101460,32822310.0,100814,104328.75
3408,61,48,21,44,212,211,200,199,275,412,410,42400,8734400.0,41989,42230.0
3409,46,38,11,25,212,211,92,91,118,304,302,19504,2964608.0,19201,22952.0
341,111,94,31,63,245,244,352,351,629,597,595,86240,25742640.0,85644,88803.75
3410,127,116,28,48,200,199,271,270,440,471,469,54200,12764100.0,53730,55224.75
3412,60,53,19,31,387,386,202,201,909,589,587,78174,23022243.0,77586,86435.75
3413,42,35,10,18,224,223,306,305,592,530,528,68544,18164160.0,68015,69960.0
3414,57,49,13,23,228,227,166,165,284,394,392,37848,7456056.0,37455,38612.0
3415,51,46,12,17,95,94,121,120,62,216,214,11495,1241460.0,11280,11556.0
3416,28,24,9,13,149,148,180,179,152,329,327,26820,4411890.0,26492,26895.75
3417,41,34,10,21,113,112,153,152,104,266,264,17289,2299437.0,17024,17556.0
3418,92,80,32,52,261,260,344,343,797,605,603,89784,27159660.0,89180,91203.75
3419,40,35,13,21,93,92,133,132,60,226,224,12369,1397697.0,12144,12656.0
342,109,74,35,98,323,322,355,354,1908,678,676,114665,38871435.0,113988,114582.0
3420,73,66,19,31,124,123,156,155,102,280,278,19344,2708160.0,19065,19460.0
3421,172,137,42,110,406,405,456,455,3156,862,860,185136,79793616.0,184275,185330.0
3422,63,57,17,27,263,262,121,120,225,384,382,31823,6110016.0,31440,36672.0
3423,28,26,10,12,136,135,115,114,69,251,249,15640,1962820.0,15390,15624.75
3424,88,69,33,67,271,270,211,210,374,482,480,57181,13780621.0,56700,57840.0
3425,42,31,11,31,192,191,118,117,146,310,308,22656,3511680.0,22347,23870.0
3426,54,44,14,31,107,106,89,88,53,196,194,9523,933254.0,9328,9506.0
3427,46,42,16,22,97,96,175,174,126,272,270,16975,2308600.0,16704,18360.0
3428,79,65,21,45,177,176,194,193,246,371,369,34338,6369699.0,33968,34224.75
3429,32,28,10,13,86,85,110,109,49,196,194,9460,927080.0,9265,9506.0
343,88,75,23,46,157,156,208,207,202,365,363,32656,5959720.0,32292,33123.75
3430,50,42,15,29,185,184,165,164,228,350,348,30525,5341875.0,30176,30450.0
3431,50,41,16,29,110,109,189,188,144,299,297,20790,3108105.0,20492,22200.75
3432,391,383,13,27,405,404,405,404,2978,810,808,164025,66430125.0,163216,163620.0
3433,73,60,25,46,199,198,254,253,414,453,451,50546,11448669.0,50094,51075.75
3434,41,31,12,30,151,150,138,137,120,289,287,20838,3011091.0,20550,20735.75
3435,57,46,21,41,115,114,223,222,176,338,336,25645,4334005.0,25308,28392.0
3436,66,59,15,24,175,174,118,117,128,293,291,20650,3025225.0,20358,21315.75
3437,48,42,14,23,241,240,143,142,195,384,382,34463,6616896.0,34080,36672.0
3438,47,39,10,23,138,137,102,101,71,240,238,14076,1689120.0,13837,14280.0
3439,27,22,10,17,104,103,209,208,168,313,311,21736,3401684.0,21424,24335.75
344,23,22,5,5,80,79,135,134,45,215,213,10800,1161000.0,10586,11448.75
3440,60,54,13,21,147,146,103,102,89,250,248,15141,1892625.0,14892,15500.0
3442,47,43,16,22,188,187,123,122,163,311,309,23124,3595782.0,22814,24024.75
3443,70,55,22,50,320,319,267,266,839,587,585,85440,25076640.0,84854,85848.75
3444,51,35,13,43,224,223,202,201,344,426,424,45248,9637824.0,44823,45156.0
3445,69,58,18,38,267,266,123,122,254,390,388,32841,6403995.0,32452,37830.0
3446,62,55,15,27,140,139,143,142,119,283,281,20020,2832830.0,19738,19880.75
3447,25,23,8,10,87,86,189,188,95,276,274,16443,2269134.0,16168,18906.0
3448,92,76,31,59,228,227,300,299,538,528,526,68400,18057600.0,67873,69432.0
3449,47,40,17,27,121,120,99,98,60,220,218,11979,1317690.0,11760,11990.0
345,53,43,18,35,423,422,252,251,1410,675,673,106596,35976150.0,105922,113568.75
3450,81,63,27,60,398,397,165,164,634,563,561,65670,18486105.0,65108,78960.75
3451,38,33,13,19,160,159,132,131,117,292,290,21120,3083520.0,20829,21170.0
3452,74,64,20,38,161,160,224,223,276,385,383,36064,6942320.0,35680,36863.75
3453,100,80,26,64,214,213,230,229,372,444,442,49220,10926840.0,48777,49062.0
3454,53,42,18,38,189,188,289,288,401,478,476,54621,13054419.0,54144,56882.0
3455,75,58,23,55,165,164,132,131,141,297,295,21780,3234330.0,21484,21903.75
3456,67,55,22,39,296,295,236,235,514,532,530,69856,18581696.0,69325,70490.0
3457,66,56,16,32,124,123,129,128,83,253,251,15996,2023494.0,15744,15875.75
3458,57,53,17,23,155,154,207,206,176,362,360,32085,5807385.0,31724,32580.0
3459,70,59,18,38,126,125,153,152,138,279,277,19278,2689281.0,19000,19320.75
346,62,48,19,45,97,96,144,143,84,241,239,13968,1683144.0,13728,14399.75
3461,98,85,25,46,201,200,210,209,323,411,409,42210,8674155.0,41800,42024.75
3462,114,95,34,67,250,249,214,213,365,464,462,53500,12412000.0,53037,53592.0
3463,137,116,42,81,370,369,228,227,1218,598,596,84360,25223640.0,83763,89102.0
3465,63,58,14,22,170,169,122,121,105,292,290,20740,3028040.0,20449,21170.0
3466,62,48,22,48,156,155,287,286,438,443,441,44772,9916998.0,44330,48840.75
3468,43,37,14,20,188,187,156,155,227,344,342,29328,5044416.0,28985,29412.0
3469,98,79,39,73,281,280,243,242,501,524,522,68283,17890146.0,67760,68382.0
347,68,59,16,31,134,133,154,153,144,288,286,20636,2971584.0,20349,20592.0
3470,31,26,10,16,82,81,115,114,50,197,195,9430,928855.0,9234,9603.75
3473,55,50,11,19,111,110,92,91,54,203,201,10212,1036518.0,10010,10200.75
3474,56,47,14,30,164,163,139,138,130,303,301,22796,3453594.0,22494,22800.75
3475,49,42,15,26,203,202,268,267,403,471,469,54404,12812142.0,53934,55224.75
3476,55,43,16,37,193,192,155,154,185,348,346,29915,5205210.0,29568,30102.0
3477,34,29,12,18,353,352,185,184,466,538,536,65305,17567045.0,64768,72092.0
3478,64,56,11,25,129,128,101,100,80,230,228,13029,1498335.0,12800,13110.0
3479,104,90,31,57,201,200,248,247,337,449,447,49848,11190876.0,49400,50175.75
348,17,16,4,4,141,140,164,163,161,305,303,23124,3526410.0,22820,23103.75
3480,75,61,27,53,323,322,302,301,769,625,623,97546,30483125.0,96922,97343.75
3481,66,63,12,16,177,176,186,185,180,363,361,32922,5975343.0,32560,32760.75
3482,53,44,19,29,124,123,184,183,173,308,306,22816,3513664.0,22509,23562.0
3483,72,62,17,33,197,196,145,144,145,342,340,28565,4884615.0,28224,29070.0
3484,110,98,27,49,272,271,288,287,716,560,558,78336,21934080.0,77777,78120.0
3485,77,67,21,38,299,298,368,367,795,667,665,110032,36695672.0,109366,110888.75
3486,40,34,13,21,155,154,138,137,167,293,291,21390,3133635.0,21098,21315.75
3487,79,69,12,27,182,181,143,142,263,325,323,26026,4229225.0,25702,26243.75
3488,20,19,5,5,162,161,119,118,91,281,279,19278,2708559.0,18998,19599.75
3489,58,49,18,34,149,148,222,221,208,371,369,33078,6135969.0,32708,34224.75
349,31,21,8,25,233,232,143,142,406,376,374,33319,6263972.0,32944,35156.0
3490,87,75,21,43,182,181,195,194,285,377,375,35490,6689865.0,35114,35343.75
3491,56,42,20,45,122,121,157,156,100,279,277,19154,2671983.0,18876,19320.75
3492,45,41,12,18,98,97,121,120,56,219,217,11858,1298451.0,11640,11880.75
3493,68,58,20,37,158,157,133,132,118,291,289,21014,3057537.0,20724,21024.75
3494,47,37,13,31,150,149,153,152,132,303,301,22950,3476925.0,22648,22800.75
3495,73,66,20,30,152,151,233,232,242,385,383,35416,6817580.0,35032,36863.75
3496,48,30,11,44,170,169,149,148,189,319,317,25330,4040135.0,25012,25280.75
3497,229,227,8,10,245,244,541,540,1858,786,784,132545,52090185.0,131760,154056.0
35,60,45,16,44,116,115,110,109,75,226,224,12760,1441880.0,12535,12656.0
350,51,42,13,28,178,177,168,167,222,346,344,29904,5173392.0,29559,29756.0
3500,41,36,11,19,107,106,101,100,47,208,206,10807,1123928.0,10600,10712.0
3501,81,65,24,53,144,143,246,245,260,390,388,35424,6907680.0,35035,37830.0
3502,36,31,10,14,100,99,163,162,114,263,261,16300,2143450.0,16038,17160.75
3503,79,62,19,50,169,168,201,200,277,370,368,33969,6284265.0,33600,34040.0
3504,68,58,21,37,131,130,127,126,80,258,256,16637,2146173.0,16380,16512.0
3505,31,25,9,19,241,240,113,112,163,354,352,27233,4820241.0,26880,31152.0
3506,58,46,22,44,155,154,219,218,268,374,372,33945,6347715.0,33572,34782.0
3507,77,56,22,59,210,209,279,278,634,489,487,58590,14325255.0,58102,59535.75
3508,34,27,11,20,139,138,130,129,95,269,267,18070,2430415.0,17802,17955.75
3509,40,34,14,24,345,344,119,118,384,464,462,41055,9524760.0,40592,53592.0
351,22,21,6,6,142,141,69,68,45,211,209,9798,1033689.0,9588,11024.75
3510,43,33,18,35,174,173,173,172,209,347,345,30102,5222697.0,29756,29928.75
3511,107,91,32,60,282,281,320,319,808,602,600,90240,27162240.0,89639,90300.0
3512,53,47,10,20,84,83,94,93,32,178,176,7896,702744.0,7719,7832.0
3513,42,32,13,31,250,249,130,129,339,380,378,32500,6175000.0,32121,35910.0
3514,67,58,13,28,154,153,177,176,166,331,329,27258,4511199.0,26928,27224.75
3515,87,74,18,42,195,194,267,266,431,462,460,52065,12027015.0,51604,53130.0
3516,31,28,10,14,181,180,229,228,271,410,408,41449,8497045.0,41040,41820.0
3517,80,66,26,50,200,199,256,255,336,456,454,51200,11673600.0,50745,51756.0
3518,66,41,21,67,231,230,345,344,952,576,574,79695,22952160.0,79120,82656.0
3519,107,94,32,55,372,371,251,250,701,623,621,93372,29085378.0,92750,96720.75
352,94,85,30,46,264,263,294,293,645,558,556,77616,21654864.0,77059,77562.0
3520,52,44,11,25,133,132,100,99,72,233,231,13300,1549450.0,13068,13455.75
3521,47,37,14,30,139,138,156,155,186,295,293,21684,3198390.0,21390,21608.75
3522,104,77,33,85,303,302,207,206,489,510,508,62721,15993855.0,62212,64770.0
3523,42,35,15,27,113,112,132,131,76,245,243,14916,1827210.0,14672,14883.75
3524,92,79,29,52,278,277,437,436,1871,715,713,121486,43431245.0,120772,127448.75
3525,118,117,6,6,124,123,124,123,76,248,246,15376,1906624.0,15129,15252.0
3526,140,132,17,31,389,388,185,184,730,574,572,71965,20653955.0,71392,82082.0
3527,35,28,12,19,115,114,183,182,113,298,296,21045,3135705.0,20748,22052.0
3528,44,38,10,18,109,108,113,112,70,222,220,12317,1367187.0,12096,12210.0
3529,72,63,19,33,148,147,162,161,161,310,308,23976,3716280.0,23667,23870.0
353,184,149,58,126,504,503,381,380,6094,885,883,192024,84970620.0,191140,195363.75
3530,42,32,12,28,116,115,150,149,88,266,264,17400,2314200.0,17135,17556.0
3531,68,58,16,32,124,123,123,122,77,247,245,15252,1883622.0,15006,15128.75
3532,66,56,24,38,220,219,274,273,551,494,492,60280,14889160.0,59787,60762.0
3533,69,59,23,39,193,192,168,167,231,361,359,32424,5852532.0,32064,32399.75
3534,102,94,25,37,232,231,193,192,418,425,423,44776,9514900.0,44352,44943.75
3535,33,31,10,12,105,104,199,198,133,304,302,20895,3176040.0,20592,22952.0
3536,61,50,14,34,137,136,139,138,146,276,274,19043,2627934.0,18768,18906.0
3537,94,72,32,70,306,305,341,340,1024,647,645,104346,33755931.0,103700,104328.75
3538,54,37,11,43,154,153,144,143,132,298,296,22176,3304224.0,21879,22052.0
3539,79,66,24,48,128,127,151,150,112,279,277,19328,2696256.0,19050,19320.75
354,128,116,31,53,277,276,267,266,765,544,542,73959,20116848.0,73416,73712.0
3540,32,23,10,24,257,256,105,104,179,362,360,26985,4884285.0,26624,32580.0
3541,62,56,14,24,276,275,149,148,327,425,423,41124,8738850.0,40700,44943.75
3542,58,51,20,32,146,145,155,154,136,301,299,22630,3405815.0,22330,22499.75
3543,105,96,32,48,205,204,349,348,675,554,552,71545,19817965.0,70992,76452.0
3544,78,56,24,59,291,290,193,192,500,484,482,56163,13591446.0,55680,58322.0
3545,53,47,17,27,204,203,115,114,145,319,317,23460,3741870.0,23142,25280.75
3546,46,37,10,22,107,106,87,86,58,194,192,9309,902973.0,9116,9312.0
3547,72,58,23,49,138,137,238,237,187,376,374,32844,6174672.0,32469,35156.0
3548,91,75,24,54,257,256,221,220,646,478,476,56797,13574483.0,56320,56882.0
3549,88,86,25,27,226,225,124,123,263,350,348,28024,4904200.0,27675,30450.0
3550,30,25,11,17,82,81,154,153,55,236,234,12628,1490104.0,12393,13806.0
3551,141,123,43,76,328,327,435,434,1327,763,761,142680,54432420.0,141918,145160.75
3552,32,30,11,13,158,157,107,106,76,265,263,16906,2240045.0,16642,17423.75
3553,94,78,30,58,284,283,389,388,1292,673,671,110476,37175174.0,109804,112895.75
3554,38,31,16,25,167,166,85,84,112,252,250,14195,1788570.0,13944,15750.0
3555,64,55,18,30,123,122,123,122,67,246,244,15129,1860867.0,14884,15006.0
3556,357,343,19,45,377,376,405,404,2433,782,780,152685,59699835.0,151904,152490.0
3557,67,55,21,42,151,150,172,171,132,323,321,25972,4194478.0,25650,25920.75
3558,101,92,24,38,363,362,250,249,657,613,611,90750,27814875.0,90138,93635.75
3559,49,47,15,17,99,98,119,118,66,218,216,11781,1284129.0,11564,11772.0
356,78,67,18,37,126,125,172,171,122,298,296,21672,3229128.0,21375,22052.0
3560,68,51,25,54,189,188,157,156,304,346,344,29673,5133429.0,29328,29756.0
3561,63,55,25,39,155,154,103,102,88,258,256,15965,2059485.0,15708,16512.0
3562,47,43,13,17,171,170,108,107,94,279,277,18468,2576286.0,18190,19320.75
3563,71,58,19,43,158,157,151,150,203,309,307,23858,3686061.0,23550,23715.75
3564,77,66,15,34,208,207,140,139,176,348,346,29120,5066880.0,28773,30102.0
3565,49,44,18,26,134,133,172,171,104,306,304,23048,3526344.0,22743,23256.0
3566,133,131,8,10,147,146,170,169,161,317,315,24990,3960915.0,24674,24963.75
3567,59,50,21,37,164,163,105,104,100,269,267,17220,2316090.0,16952,17955.75
3568,67,61,16,25,100,99,191,190,111,291,289,19100,2779050.0,18810,21024.75
3569,35,30,10,16,159,158,140,139,132,299,297,22260,3327870.0,21962,22200.75
357,69,55,24,48,402,401,423,422,3129,825,823,170046,70143975.0,169222,169743.75
3570,98,82,33,62,334,333,199,198,683,533,531,66466,17713189.0,65934,70755.75
3571,21,19,8,10,196,195,117,116,196,313,311,22932,3588858.0,22620,24335.75
3572,39,37,10,11,195,194,142,141,132,337,335,27690,4665765.0,27354,28223.75
3573,113,99,43,68,427,426,378,377,2148,805,803,161406,64965915.0,160602,161603.75
3574,31,21,8,26,173,172,84,83,73,257,255,14532,1867362.0,14276,16383.75
3575,39,36,9,13,209,208,116,115,161,325,323,24244,3939650.0,23920,26243.75
3576,56,45,20,40,171,170,111,110,151,282,280,18981,2676321.0,18700,19740.0
3577,99,91,30,42,204,203,302,301,436,506,504,61608,15586824.0,61103,63756.0
3578,76,62,18,41,198,197,143,142,140,341,339,28314,4827537.0,27974,28899.75
3579,74,64,23,41,126,125,160,159,115,286,284,20160,2882880.0,19875,20306.0
358,84,73,32,51,185,184,258,257,330,443,441,47730,10572195.0,47288,48840.75
3580,69,64,19,26,106,105,172,171,115,278,276,18232,2534248.0,17955,19182.0
3581,69,57,17,38,262,261,197,196,547,459,457,51614,11845413.0,51156,52440.75
3582,44,40,9,14,105,104,122,121,64,227,225,12810,1453935.0,12584,12768.75
3583,50,39,16,36,224,223,165,164,188,389,387,36960,7188720.0,36572,37635.75
3584,88,74,29,55,182,181,181,180,264,363,361,32942,5978973.0,32580,32760.75
3585,50,37,12,36,145,144,187,186,167,332,330,27115,4501090.0,26784,27390.0
3586,50,39,14,33,118,117,141,140,95,259,257,16638,2154621.0,16380,16640.75
3587,70,61,18,34,250,249,416,415,1344,666,664,104000,34632000.0,103335,110556.0
3588,25,22,8,11,111,110,227,226,188,338,336,25197,4258293.0,24860,28392.0
3589,33,31,6,8,137,136,149,148,148,286,284,20413,2919059.0,20128,20306.0
359,89,77,26,46,198,197,203,202,337,401,399,40194,8058897.0,39794,39999.75
3590,69,56,19,43,323,322,161,160,498,484,482,52003,12584726.0,51520,58322.0
3593,55,47,17,31,113,112,148,147,86,261,259,16724,2182482.0,16464,16899.75
3594,70,56,21,40,258,257,465,464,2121,723,721,119970,43369155.0,119248,130320.75
3595,36,28,12,22,121,120,223,222,229,344,342,26983,4641076.0,26640,29412.0
3596,60,53,20,28,212,211,145,144,246,357,355,30740,5487090.0,30384,31683.75
3597,42,36,16,26,156,155,120,119,90,276,274,18720,2583360.0,18445,18906.0
3598,63,47,15,43,129,128,158,157,135,287,285,20382,2924817.0,20096,20448.75
3599,46,38,18,30,162,161,164,163,143,326,324,26568,4330584.0,26243,26406.0
36,67,54,22,43,139,138,267,266,294,406,404,37113,7533939.0,36708,41006.0
360,57,45,18,40,157,156,163,162,139,320,318,25591,4094560.0,25272,25440.0
3600,48,38,15,31,197,196,112,111,129,309,307,22064,3408888.0,21756,23715.75
3601,34,30,16,21,227,226,376,375,538,603,601,85352,25733628.0,84750,90600.75
3602,99,76,34,77,311,310,207,206,632,518,516,64377,16673643.0,63860,66822.0
3603,46,37,19,35,126,125,84,83,50,210,208,10584,1111320.0,10375,10920.0
3604,40,30,11,27,116,115,79,78,46,195,193,9164,893490.0,8970,9408.75
3605,63,60,14,17,175,174,117,116,150,292,290,20475,2989350.0,20184,21170.0
3606,63,45,14,44,151,150,116,115,113,267,265,17516,2338386.0,17250,17688.75
3607,59,47,18,38,191,190,169,168,227,360,358,32279,5810220.0,31920,32220.0
3608,39,32,15,27,130,129,267,266,224,397,395,34710,6889935.0,34314,39203.75
3609,72,59,14,37,171,170,120,119,110,291,289,20520,2985660.0,20230,21024.75
361,95,72,39,83,364,363,272,271,862,636,634,99008,31484544.0,98373,100806.0
3610,60,48,19,39,134,133,166,165,123,300,298,22244,3336600.0,21945,22350.0
3611,47,38,15,30,135,134,156,155,126,291,289,21060,3064230.0,20770,21024.75
3612,44,38,11,17,98,97,101,100,45,199,197,9898,984851.0,9700,9800.75
3613,46,38,15,26,178,177,177,176,224,355,353,31506,5592315.0,31152,31328.75
3614,22,21,6,6,79,78,172,171,78,251,249,13588,1705294.0,13338,15624.75
3616,87,68,30,65,436,435,346,345,2251,782,780,150856,58984696.0,150075,152490.0
3617,68,58,19,36,182,181,214,213,402,396,394,38948,7711704.0,38553,39006.0
3618,37,30,12,23,112,111,81,80,44,193,191,9072,875448.0,8880,9215.75
3619,82,66,22,49,209,208,153,152,222,362,360,31977,5787837.0,31616,32580.0
3620,29,20,8,16,163,162,158,157,188,321,319,25754,4133517.0,25434,25599.75
3621,44,39,13,19,172,171,215,214,254,387,385,36980,7155630.0,36594,37248.75
3622,107,90,35,67,260,259,298,297,727,558,556,77480,21616920.0,76923,77562.0
3623,53,41,12,28,185,184,138,137,185,323,321,25530,4123095.0,25208,25920.75
3624,74,67,22,34,205,204,118,117,159,323,321,24190,3906685.0,23868,25920.75
3625,55,50,22,30,114,113,373,372,285,487,485,42522,10354107.0,42036,59048.75
3626,42,33,6,15,100,99,125,124,57,225,223,12500,1406250.0,12276,12543.75
3627,32,29,13,16,428,427,260,259,1169,688,686,111280,38280320.0,110593,117992.0
3628,103,97,20,30,335,334,189,188,622,524,522,63315,16588530.0,62792,68382.0
3629,121,100,44,83,345,344,327,326,1286,672,670,112815,37905840.0,112144,112560.0
363,30,26,11,16,133,132,177,176,139,310,308,23541,3648855.0,23232,23870.0
3630,89,67,28,69,317,316,450,449,1629,767,765,142650,54706275.0,141884,146688.75
3631,78,65,29,53,197,196,307,306,533,504,502,60479,15240708.0,59976,63252.0
3632,88,72,32,62,185,184,214,213,249,399,397,39590,7898205.0,39192,39600.75
3633,82,68,25,50,274,273,422,421,2309,696,694,115628,40238544.0,114933,120756.0
3634,79,74,15,22,177,176,134,133,116,311,309,23718,3688149.0,23408,24024.75
3635,56,46,15,31,127,126,189,188,122,316,314,24003,3792474.0,23688,24806.0
3636,41,37,17,23,153,152,113,112,78,266,264,17289,2299437.0,17024,17556.0
3637,59,46,20,43,131,130,206,205,290,337,335,26986,4547141.0,26650,28223.75
3639,77,66,17,36,124,123,199,198,139,323,321,24676,3985174.0,24354,25920.75
364,54,51,17,21,267,266,203,202,825,470,468,54201,12737235.0,53732,54990.0
3640,50,36,17,41,121,120,145,144,112,266,264,17545,2333485.0,17280,17556.0
3641,45,35,15,32,159,158,116,115,114,275,273,18444,2536050.0,18170,18768.75
3642,19,16,5,9,167,166,317,316,418,484,482,52939,12811238.0,52456,58322.0
3643,70,52,21,53,157,156,200,199,249,357,355,31400,5604900.0,31044,31683.75
3644,29,25,8,13,110,109,108,107,64,218,216,11880,1294920.0,11663,11772.0
3645,50,42,20,34,227,226,215,214,342,442,440,48805,10785905.0,48364,48620.0
3646,72,66,22,32,138,137,167,166,128,305,303,23046,3514515.0,22742,23103.75
3647,65,55,23,39,180,179,187,186,273,367,365,33660,6176610.0,33294,33488.75
3649,77,70,22,34,141,140,177,176,147,318,316,24957,3968163.0,24640,25122.0
365,50,42,16,30,191,190,114,113,126,305,303,21774,3320535.0,21470,23103.75
3650,63,55,22,36,91,90,178,177,98,269,267,16198,2178631.0,15930,17955.75
3651,99,86,22,44,250,249,178,177,307,428,426,44500,9523000.0,44073,45582.0
3652,54,43,21,41,117,116,153,152,97,270,268,17901,2416635.0,17632,18090.0
3653,46,36,16,29,275,274,216,215,422,491,489,59400,14582700.0,58910,60024.75
3654,27,26,6,6,97,96,85,84,29,182,180,8245,750295.0,8064,8190.0
3655,130,110,21,57,288,287,227,226,732,515,513,65376,16834320.0,64862,66048.75
3656,84,59,23,69,227,226,246,245,428,473,471,55842,13206633.0,55370,55695.75
3657,89,75,28,52,301,300,306,305,1173,607,605,92106,27954171.0,91500,91808.75
3658,74,61,25,49,265,264,194,193,466,459,457,51410,11798595.0,50952,52440.75
3659,36,34,9,10,98,97,130,129,58,228,226,12740,1452360.0,12513,12882.0
366,78,68,15,33,125,124,107,106,53,232,230,13375,1551500.0,13144,13340.0
3660,50,46,10,15,280,279,190,189,389,470,468,53200,12502000.0,52731,54990.0
3661,73,68,21,29,123,122,242,241,231,365,363,29766,5432295.0,29402,33123.75
3662,22,19,8,11,154,153,133,132,106,287,285,20482,2939167.0,20196,20448.75
3663,20,17,6,8,125,124,134,133,83,259,257,16750,2169125.0,16492,16640.75
3664,147,125,51,93,343,342,295,294,804,638,636,101185,32278015.0,100548,101442.0
3665,82,70,28,49,272,271,318,317,880,590,588,86496,25516320.0,85907,86730.0
3666,76,61,24,52,184,183,278,277,375,462,460,51152,11816112.0,50691,53130.0
3667,75,63,21,42,219,218,160,159,287,379,377,35040,6640080.0,34662,35720.75
3668,62,56,18,28,159,158,157,156,216,316,314,24963,3944154.0,24648,24806.0
3669,96,87,16,31,143,142,127,126,94,270,268,18161,2451735.0,17892,18090.0
367,47,44,14,18,178,177,192,191,214,370,368,34176,6322560.0,33807,34040.0
3670,61,48,17,40,164,163,125,124,147,289,287,20500,2962250.0,20212,20735.75
3671,53,49,13,19,203,202,131,130,185,334,332,26593,4441031.0,26260,27722.0
3672,87,79,26,40,149,148,239,238,245,388,386,35611,6908534.0,35224,37442.0
3673,45,34,15,35,103,102,118,117,61,221,219,12154,1343017.0,11934,12099.75
3674,56,44,13,33,101,100,113,112,55,214,212,11413,1221191.0,11200,11342.0
3675,95,77,28,60,280,279,159,158,380,439,437,44520,9772140.0,44082,47960.75
3676,45,43,15,17,134,133,106,105,71,240,238,14204,1704480.0,13965,14280.0
3677,61,49,14,36,178,177,126,125,146,304,302,22428,3409056.0,22125,22952.0
3678,52,45,10,21,104,103,195,194,150,299,297,20280,3031860.0,19982,22200.75
3679,40,33,14,26,144,143,89,88,71,233,231,12816,1493064.0,12584,13455.75
3681,56,50,21,31,142,141,190,189,132,332,330,26980,4478680.0,26649,27390.0
3682,32,26,8,15,157,156,238,237,339,395,393,37366,7379785.0,36972,38808.75
3683,106,95,25,43,304,303,477,476,1529,781,779,145008,56625624.0,144228,152099.75
3684,102,79,35,79,258,257,277,276,653,535,533,71466,19117155.0,70932,71288.75
3685,40,33,14,23,213,212,215,214,351,428,426,45795,9800130.0,45368,45582.0
3687,35,30,11,17,99,98,109,108,44,208,206,10791,1122264.0,10584,10712.0
3688,54,44,21,39,190,189,222,221,407,412,410,42180,8689080.0,41769,42230.0
369,124,99,35,81,291,290,330,329,859,621,619,96030,29817315.0,95410,96099.75
3690,26,22,9,14,226,225,125,124,144,351,349,28250,4957875.0,27900,30624.75
3691,33,22,7,17,142,141,84,83,63,226,224,11928,1347864.0,11703,12656.0
3692,75,64,28,48,147,146,185,184,146,332,330,27195,4514370.0,26864,27390.0
3693,52,42,14,29,117,116,137,136,97,254,252,16029,2035683.0,15776,16002.0
3694,44,37,15,27,135,134,138,137,111,273,271,18630,2542995.0,18358,18495.75
3695,113,107,13,23,216,215,178,177,298,394,392,38448,7574256.0,38055,38612.0
3696,67,50,21,53,202,201,183,182,308,385,383,36966,7115955.0,36582,36863.75
3697,112,79,34,98,240,239,246,245,459,486,484,59040,14346720.0,58555,58806.0
3698,77,65,26,48,241,240,192,191,300,433,431,46272,10017888.0,45840,46655.75
3699,173,128,57,144,431,430,395,394,2787,826,824,170245,70311185.0,169420,170156.0
37,48,42,16,26,140,139,70,69,49,210,208,9800,1029000.0,9591,10920.0
370,73,62,17,37,109,108,157,156,155,266,264,17113,2276029.0,16848,17556.0
3700,74,60,23,49,320,319,332,331,957,652,650,106240,34634240.0,105589,105950.0
3701,53,42,15,32,131,130,110,109,99,241,239,14410,1736405.0,14170,14399.75
3702,175,143,55,116,345,344,503,502,2257,848,846,173535,73578840.0,172688,179352.0
3703,129,117,36,58,240,239,267,266,614,507,505,64080,16244280.0,63574,64008.75
3704,56,46,14,28,100,99,83,82,54,183,181,8300,759450.0,8118,8280.75
3705,52,34,17,48,114,113,95,94,58,209,207,10830,1131735.0,10622,10815.75
3706,35,28,15,24,159,158,91,90,69,250,248,14469,1808625.0,14220,15500.0
3707,60,55,19,27,373,372,343,342,1393,716,714,127939,45802162.0,127224,127806.0
3708,44,38,12,22,113,112,96,95,56,209,207,10848,1133616.0,10640,10815.75
3709,67,49,25,59,262,261,265,264,685,527,525,69430,18294805.0,68904,69168.75
371,35,32,10,13,158,157,196,195,195,354,352,30968,5481336.0,30615,31152.0
3710,107,85,37,79,414,413,426,425,1858,840,838,176364,74072880.0,175525,175980.0
3711,34,30,10,15,92,91,120,119,49,212,210,11040,1170240.0,10829,11130.0
3712,61,50,20,40,157,156,117,116,91,274,272,18369,2516553.0,18096,18632.0
3713,27,23,9,12,107,106,208,207,109,315,313,22256,3505320.0,21942,24648.75
3714,29,24,10,16,280,279,280,279,721,560,558,78400,21952000.0,77841,78120.0
3715,63,56,15,26,139,138,233,232,218,372,370,32387,6023982.0,32016,34410.0
3718,98,82,29,59,318,317,382,381,2154,700,698,121476,42516600.0,120777,122150.0
3719,102,77,37,85,496,495,446,445,5071,942,940,221216,104192736.0,220275,221370.0
372,96,74,26,62,267,266,341,340,1203,608,606,91047,27678288.0,90440,92112.0
3720,78,70,27,41,220,219,195,194,271,415,413,42900,8901750.0,42486,42848.75
3721,94,68,28,78,262,261,241,240,601,503,501,63142,15880213.0,62640,63000.75
3722,66,50,21,47,154,153,173,172,212,327,325,26642,4355967.0,26316,26568.75
3723,62,51,22,42,237,236,138,137,217,375,373,32706,6132375.0,32332,34968.75
3724,40,36,14,20,232,231,162,161,278,394,392,37584,7404048.0,37191,38612.0
3725,59,48,20,39,147,146,210,209,194,357,355,30870,5510295.0,30514,31683.75
3726,57,45,17,38,135,134,159,158,129,294,292,21465,3155355.0,21172,21462.0
3727,76,68,17,31,147,146,158,157,155,305,303,23226,3541965.0,22922,23103.75
3728,77,67,22,40,137,136,206,205,181,343,341,28222,4840073.0,27880,29240.75
3729,70,49,19,56,271,270,215,214,438,486,484,58265,14158395.0,57780,58806.0
373,44,40,10,16,206,205,143,142,168,349,347,29458,5140421.0,29110,30275.75
3730,58,55,10,14,126,125,85,84,39,211,209,10710,1129905.0,10500,11024.75
3731,110,87,39,82,260,259,462,461,1124,722,720,120120,43363320.0,119399,129960.0
3732,100,84,29,59,254,253,192,191,431,446,444,48768,10875264.0,48323,49506.0
3733,57,48,22,38,276,275,286,285,613,562,560,78936,22181016.0,78375,78680.0
3734,20,18,7,9,100,99,112,111,52,212,210,11200,1187200.0,10989,11130.0
3735,22,20,8,9,61,60,96,95,29,157,155,5856,459696.0,5700,6083.75
3736,64,51,18,42,145,144,163,162,144,308,306,23635,3639790.0,23328,23562.0
3737,32,26,11,17,109,108,139,138,62,248,246,15151,1878724.0,14904,15252.0
3738,16,15,4,4,127,126,89,88,55,216,214,11303,1220724.0,11088,11556.0
3739,61,48,22,44,345,344,327,326,1140,672,670,112815,37905840.0,112144,112560.0
374,38,33,15,23,118,117,128,127,84,246,244,15104,1857792.0,14859,15006.0
3740,19,18,3,3,171,170,115,114,111,286,284,19665,2812095.0,19380,20306.0
3741,85,78,18,25,188,187,161,160,213,349,347,30268,5281766.0,29920,30275.75
3742,25,22,8,11,135,134,133,132,96,268,266,17955,2405970.0,17688,17822.0
3743,48,39,13,27,170,169,131,130,140,301,299,22270,3351635.0,21970,22499.75
3744,71,65,25,35,189,188,118,117,146,307,305,22302,3423357.0,21996,23408.75
3745,75,62,22,45,144,143,267,266,312,411,409,38448,7901064.0,38038,42024.75
3746,134,114,42,80,385,384,355,354,1733,740,738,136675,50569750.0,135936,136530.0
3747,37,29,12,26,224,223,150,149,290,374,372,33600,6283200.0,33227,34782.0
3748,73,58,22,50,204,203,245,244,387,449,447,49980,11220510.0,49532,50175.75
3749,125,119,13,23,147,146,178,177,212,325,323,26166,4251975.0,25842,26243.75
375,92,74,41,72,356,355,401,400,1448,757,755,142756,54033146.0,142000,142883.75
3750,133,105,48,101,536,535,315,314,1960,851,849,168840,71841420.0,167990,180624.75
3751,98,84,30,56,338,337,166,165,509,504,502,56108,14139216.0,55605,63252.0
3752,59,50,17,33,206,205,109,108,146,315,313,22454,3536505.0,22140,24648.75
3753,67,47,19,57,202,201,154,153,223,356,354,31108,5537224.0,30753,31506.0
3754,87,71,32,61,444,443,435,434,2452,879,877,193140,84885030.0,192262,192720.75
3755,46,37,13,29,117,116,137,136,87,254,252,16029,2035683.0,15776,16002.0
3756,53,42,19,39,270,269,289,288,1036,559,557,78030,21809385.0,77472,77840.75
3757,209,197,31,52,293,292,516,515,1715,809,807,151188,61155546.0,150380,163215.75
3758,40,36,10,14,149,148,92,91,111,241,239,13708,1651814.0,13468,14399.75
3759,88,74,23,49,133,132,196,195,139,329,327,26068,4288186.0,25740,26895.75
376,54,44,15,27,133,132,174,173,167,307,305,23142,3552297.0,22836,23408.75
3760,68,60,22,36,378,377,196,195,805,574,572,74088,21263256.0,73515,82082.0
3761,56,44,19,38,137,136,167,166,153,304,302,22879,3477608.0,22576,22952.0
3762,54,48,17,27,123,122,126,125,73,249,247,15498,1929501.0,15250,15375.75
3763,70,60,15,32,154,153,155,154,162,309,307,23870,3687915.0,23562,23715.75
3764,62,53,16,32,113,112,138,137,94,251,249,15594,1957047.0,15344,15624.75
3765,39,31,13,23,117,116,94,93,52,211,209,10998,1160289.0,10788,11024.75
3768,36,30,9,18,117,116,97,96,57,214,212,11349,1214343.0,11136,11342.0
3769,47,40,15,24,204,203,133,132,154,337,335,27132,4571742.0,26796,28223.75
377,160,159,11,11,170,169,193,192,221,363,361,32810,5955015.0,32448,32760.75
3770,85,68,30,61,181,180,254,253,364,435,433,45974,9999345.0,45540,47088.75
3771,88,82,26,36,186,185,226,225,361,412,410,42036,8659416.0,41625,42230.0
3772,137,112,40,86,311,310,301,300,864,612,610,93611,28644966.0,93000,93330.0
3773,78,64,28,51,227,226,326,325,619,553,551,74002,20461553.0,73450,76175.75
3774,59,49,23,40,261,260,175,174,471,436,434,45675,9957150.0,45240,47306.0
3775,60,56,16,22,128,127,133,132,91,261,259,17024,2221632.0,16764,16899.75
3776,56,48,19,33,171,170,133,132,215,304,302,22743,3456936.0,22440,22952.0
3777,48,39,16,31,343,342,109,108,267,452,450,37387,8449462.0,36936,50850.0
3778,57,45,15,37,242,241,131,130,221,373,371,31702,5912423.0,31330,34595.75
3779,39,32,12,23,170,169,145,144,151,315,313,24650,3882375.0,24336,24648.75
378,58,40,19,53,224,223,166,165,308,390,388,37184,7250880.0,36795,37830.0
3780,67,60,21,32,148,147,197,196,199,345,343,29156,5029410.0,28812,29583.75
3781,86,73,28,52,269,268,164,163,378,433,431,44116,9551114.0,43684,46655.75
3782,45,37,12,24,176,175,99,98,162,275,273,17424,2395800.0,17150,18768.75
3784,49,39,14,31,145,144,129,128,141,274,272,18705,2562585.0,18432,18632.0
3785,75,61,27,52,258,257,284,283,603,542,540,73272,19856712.0,72731,73170.0
3786,64,59,17,25,119,118,123,122,74,242,240,14637,1771077.0,14396,14520.0
3787,58,55,8,11,99,98,136,135,59,235,233,13464,1582020.0,13230,13688.75
3788,55,47,22,36,176,175,220,219,274,396,394,38720,7666560.0,38325,39006.0
3789,61,46,21,46,279,278,528,527,2333,807,805,147312,59440392.0,146506,162408.75
379,43,37,11,21,85,84,117,116,37,202,200,9945,1004445.0,9744,10100.0
3790,100,84,31,61,208,207,202,201,238,410,408,42016,8613280.0,41607,41820.0
3791,96,82,43,67,333,332,486,485,2332,819,817,161838,66272661.0,161020,167280.75
3793,58,54,12,18,133,132,130,129,103,263,261,17290,2273635.0,17028,17160.75
3794,91,79,30,48,251,250,316,315,615,567,565,79316,22486086.0,78750,80088.75
3795,109,94,34,62,198,197,418,417,935,616,614,82764,25491312.0,82149,94556.0
3796,52,46,15,23,110,109,104,103,54,214,212,11440,1224080.0,11227,11342.0
3798,107,103,11,17,285,284,178,177,417,463,461,50730,11743995.0,50268,53360.75
3799,119,118,5,5,124,123,124,123,74,248,246,15376,1906624.0,15129,15252.0
38,92,74,27,60,272,271,435,434,1769,707,705,118320,41826120.0,117614,124608.75
380,149,135,39,64,250,249,240,239,550,490,488,60000,14700000.0,59511,59780.0
3800,92,79,21,42,175,174,201,200,239,376,374,35175,6612900.0,34800,35156.0
3801,118,114,12,18,147,146,178,177,180,325,323,26166,4251975.0,25842,26243.75
3802,37,30,9,21,165,164,157,156,156,322,320,25905,4170705.0,25584,25760.0
3803,43,35,17,28,181,180,450,449,827,631,629,81450,25697475.0,80820,99224.75
3804,43,35,9,23,105,104,92,91,42,197,195,9660,951510.0,9464,9603.75
3805,26,22,5,9,124,123,86,85,54,210,208,10664,1119720.0,10455,10920.0
3806,59,48,21,35,145,144,200,199,265,345,343,29000,5002500.0,28656,29583.75
3807,85,70,27,52,228,227,169,168,386,397,395,38532,7648602.0,38136,39203.75
3808,60,56,13,19,140,139,154,153,111,294,292,21560,3169320.0,21267,21462.0
3809,80,72,20,34,171,170,212,211,258,383,381,36252,6942258.0,35870,36480.75
381,37,30,10,19,72,71,105,104,29,177,175,7560,669060.0,7384,7743.75
3810,19,16,7,10,178,177,106,105,131,284,282,18868,2679256.0,18585,20022.0
3811,49,48,14,14,143,142,121,120,107,264,262,17303,2283996.0,17040,17292.0
3812,71,66,13,19,110,109,105,104,63,215,213,11550,1241625.0,11336,11448.75
3813,58,51,12,24,105,104,120,119,62,225,223,12600,1417500.0,12376,12543.75
3814,26,24,7,8,161,160,121,120,108,282,280,19481,2746821.0,19200,19740.0
3815,89,73,35,63,235,234,208,207,319,443,441,48880,10826920.0,48438,48840.75
3816,45,38,15,27,145,144,166,165,124,311,309,24070,3742885.0,23760,24024.75
3817,100,78,29,71,290,289,536,535,2434,826,824,155440,64196720.0,154615,170156.0
3818,54,48,17,26,124,123,124,123,70,248,246,15376,1906624.0,15129,15252.0
3819,108,93,33,60,475,474,390,389,4033,865,863,185250,80120625.0,184386,186623.75
382,58,48,18,36,232,231,197,196,308,429,427,45704,9803508.0,45276,45795.75
3820,100,84,29,58,232,231,236,235,505,468,466,54752,12811968.0,54285,54522.0
3821,57,49,19,32,158,157,224,223,268,382,380,35392,6759872.0,35011,36290.0
3822,131,113,44,77,418,417,506,505,4174,924,922,211508,97716696.0,210585,212982.0
3824,75,64,25,44,261,260,186,185,308,447,445,48546,10850031.0,48100,49728.75
3825,98,97,4,4,124,123,147,146,107,271,269,18228,2469894.0,17958,18224.75
3826,51,43,14,27,109,108,175,174,131,284,282,19075,2708650.0,18792,20022.0
3827,36,30,10,19,260,259,153,152,255,413,411,39780,8214570.0,39368,42435.75
3828,55,41,15,39,97,96,125,124,61,222,220,12125,1345875.0,11904,12210.0
3829,42,33,14,28,143,142,154,153,120,297,295,22022,3270267.0,21726,21903.75
383,28,25,10,14,109,108,171,170,116,280,278,18639,2609460.0,18360,19460.0
3830,54,48,19,27,169,168,124,123,120,293,291,20956,3070054.0,20664,21315.75
3831,29,27,6,7,116,115,165,164,97,281,279,19140,2689170.0,18860,19599.75
3832,58,49,20,33,169,168,162,161,147,331,329,27378,4531059.0,27048,27224.75
3833,77,50,30,74,190,189,179,178,298,369,367,34010,6274845.0,33642,33855.75
3834,54,52,13,15,94,93,77,76,32,171,169,7238,618849.0,7068,7224.75
3835,92,76,34,64,322,321,160,159,548,482,480,51520,12416320.0,51039,57840.0
3836,35,30,11,17,109,108,193,192,125,302,300,21037,3176587.0,20736,22650.0
3837,45,36,12,28,138,137,108,107,92,246,244,14904,1833192.0,14659,15006.0
3838,42,35,11,19,94,93,109,108,50,203,201,10246,1039969.0,10044,10200.75
3839,30,23,10,17,157,156,147,146,133,304,302,23079,3508008.0,22776,22952.0
384,30,23,9,18,147,146,143,142,97,290,288,21021,3048045.0,20732,20880.0
3840,38,32,14,23,225,224,176,175,279,401,399,39600,7939800.0,39200,39999.75
3841,47,41,23,33,143,142,493,492,892,636,634,70499,22418682.0,69864,100806.0
3842,28,22,7,16,130,129,186,185,202,316,314,24180,3820440.0,23865,24806.0
3843,73,58,26,52,210,209,207,206,258,417,415,43470,9063495.0,43054,43263.75
3844,63,50,25,47,124,123,193,192,134,317,315,23932,3793222.0,23616,24963.75
3845,26,24,6,8,156,155,127,126,85,283,281,19812,2803398.0,19530,19880.75
3846,62,53,18,33,132,131,117,116,85,249,247,15444,1922778.0,15196,15375.75
3847,125,119,13,23,147,146,178,177,206,325,323,26166,4251975.0,25842,26243.75
3848,23,17,7,13,101,100,127,126,72,228,226,12827,1462278.0,12600,12882.0
3849,111,92,35,71,272,271,268,267,712,540,538,72896,19681920.0,72357,72630.0
385,100,82,22,55,186,185,185,184,253,371,369,34410,6383055.0,34040,34224.75
3850,64,55,21,35,178,177,166,165,229,344,342,29548,5082256.0,29205,29412.0
3851,63,58,17,25,143,142,136,135,112,279,277,19448,2712996.0,19170,19320.75
3853,94,84,26,43,174,173,214,213,210,388,386,37236,7223784.0,36849,37442.0
3854,29,24,9,15,97,96,173,172,81,270,268,16781,2265435.0,16512,18090.0
3855,67,55,17,38,103,102,151,150,84,254,252,15553,1975231.0,15300,16002.0
3856,27,20,10,19,141,140,201,200,205,342,340,28341,4846311.0,28000,29070.0
3857,69,58,22,42,108,107,160,159,125,268,266,17280,2315520.0,17013,17822.0
3859,105,89,40,69,248,247,360,359,824,608,606,89280,27141120.0,88673,92112.0
386,37,33,19,25,83,82,263,262,181,346,344,21829,3776417.0,21484,29756.0
3860,30,27,10,14,236,235,104,103,134,340,338,24544,4172480.0,24205,28730.0
3861,59,55,18,24,175,174,90,89,100,265,263,15750,2086875.0,15486,17423.75
3862,28,27,8,8,182,181,188,187,291,370,368,34216,6329960.0,33847,34040.0
3863,65,57,23,37,213,212,162,161,291,375,373,34506,6469875.0,34132,34968.75
3865,23,22,7,7,85,84,148,147,72,233,231,12580,1465570.0,12348,13455.75
3866,62,51,11,31,108,107,210,209,148,318,316,22680,3606120.0,22363,25122.0
3867,92,79,29,52,248,247,435,434,1219,683,681,107880,36841020.0,107198,116280.75
3868,64,55,11,27,149,148,121,120,137,270,268,18029,2433915.0,17760,18090.0
3869,50,39,16,35,125,124,101,100,71,226,224,12625,1426625.0,12400,12656.0
387,56,36,16,48,124,123,143,142,111,267,265,17732,2367222.0,17466,17688.75
3870,26,21,7,14,187,186,244,243,363,431,429,45628,9832834.0,45198,46224.75
3871,51,45,19,29,140,139,128,127,87,268,266,17920,2401280.0,17653,17822.0
3872,44,29,12,31,207,206,247,246,343,454,452,51129,11606283.0,50676,51302.0
3873,37,33,8,14,124,123,82,81,46,206,204,10168,1047304.0,9963,10506.0
3874,80,65,26,52,181,180,220,219,296,401,399,39820,7983910.0,39420,39999.75
3875,33,30,9,13,103,102,97,96,52,200,198,9991,999100.0,9792,9900.0
3876,85,67,30,62,221,220,246,245,765,467,465,54366,12694461.0,53900,54288.75
3878,49,34,12,36,102,101,145,144,113,247,245,14790,1826565.0,14544,15128.75
3879,58,47,22,41,197,196,200,199,271,397,395,39400,7820900.0,39004,39203.75
388,69,61,19,33,148,147,259,258,230,407,405,38332,7800562.0,37926,41208.75
3880,78,66,24,42,193,192,205,204,382,398,396,39565,7873435.0,39168,39402.0
3881,33,30,15,19,154,153,307,306,335,461,459,47278,10897579.0,46818,52899.75
3882,51,35,17,36,181,180,205,204,534,386,384,37105,7161265.0,36720,37056.0
3883,105,80,41,89,330,329,267,266,954,597,595,88110,26300835.0,87514,88803.75
3884,46,35,19,32,263,262,209,208,620,472,470,54967,12972212.0,54496,55460.0
3885,73,69,20,25,150,149,103,102,66,253,251,15450,1954425.0,15198,15875.75
3886,126,120,13,22,178,177,170,169,207,348,346,30260,5265240.0,29913,30102.0
3887,59,48,22,42,195,194,237,236,265,432,430,46215,9982440.0,45784,46440.0
3888,44,40,11,17,305,304,171,170,401,476,474,52155,12412890.0,51680,56406.0
3889,69,51,16,49,137,136,136,135,139,273,271,18632,2543268.0,18360,18495.75
389,79,74,19,27,142,141,120,119,73,262,260,17040,2232240.0,16779,17030.0
3890,40,32,9,17,108,107,122,121,69,230,228,13176,1515240.0,12947,13110.0
3891,57,48,14,25,157,156,141,140,97,298,296,22137,3298413.0,21840,22052.0
3892,31,28,10,14,209,208,105,104,119,314,312,21945,3445365.0,21632,24492.0
3893,53,45,19,30,242,241,341,340,689,583,581,82522,24055163.0,81940,84680.75
3894,59,53,16,25,152,151,178,177,164,330,328,27056,4464240.0,26727,27060.0
3895,58,48,16,34,117,116,148,147,100,265,263,17316,2294370.0,17052,17423.75
3896,94,81,25,49,181,180,167,166,174,348,346,30227,5259498.0,29880,30102.0
3897,37,26,12,30,424,423,233,232,1557,657,655,98792,32453172.0,98136,107583.75
3898,50,43,20,31,188,187,194,193,202,382,380,36472,6966152.0,36091,36290.0
3899,65,59,13,23,128,127,101,100,61,229,227,12928,1480256.0,12700,12995.75
39,39,31,11,22,175,174,94,93,134,269,267,16450,2212525.0,16182,17955.75
390,59,56,18,22,142,141,142,141,105,284,282,20164,2863288.0,19881,20022.0
3900,122,93,38,92,392,391,319,318,1026,711,709,125048,44454564.0,124338,126024.75
3901,42,40,13,15,215,214,357,356,695,572,570,76755,21951930.0,76184,81510.0
3903,61,52,17,33,156,155,160,159,150,316,314,24960,3943680.0,24645,24806.0
3904,84,71,31,54,199,198,279,278,520,478,476,55521,13269519.0,55044,56882.0
3905,95,83,28,50,255,254,219,218,553,474,472,55845,13235265.0,55372,55932.0
3906,51,44,10,19,85,84,133,132,41,218,216,11305,1232245.0,11088,11772.0
3907,81,63,23,57,213,212,144,143,261,357,355,30672,5474952.0,30316,31683.75
3908,54,45,16,32,138,137,222,221,182,360,358,30636,5514480.0,30277,32220.0
3909,62,52,14,31,103,102,132,131,77,235,233,13596,1597530.0,13362,13688.75
391,74,58,19,49,161,160,183,182,182,344,342,29463,5067636.0,29120,29412.0
3910,21,18,6,8,216,215,240,239,455,456,454,51840,11819520.0,51385,51756.0
3911,45,35,15,33,217,216,197,196,322,414,412,42749,8849043.0,42336,42642.0
3912,55,39,18,47,105,104,192,191,173,297,295,20160,2993760.0,19864,21903.75
3913,40,39,13,13,158,157,136,135,121,294,292,21488,3158736.0,21195,21462.0
3914,63,57,16,25,161,160,175,174,160,336,334,28175,4733400.0,27840,28056.0
3915,42,32,12,26,151,150,181,180,165,332,330,27331,4536946.0,27000,27390.0
3916,52,39,15,36,151,150,127,126,96,278,276,19177,2665603.0,18900,19182.0
3918,71,47,27,70,256,255,219,218,440,475,473,56064,13315200.0,55590,56168.75
3919,70,65,15,22,102,101,128,127,63,230,228,13056,1501440.0,12827,13110.0
392,88,75,29,53,209,208,152,151,240,361,359,31768,5734124.0,31408,32399.75
3920,46,36,11,27,96,95,121,120,122,217,215,11616,1260336.0,11400,11663.75
3921,69,60,24,40,154,153,246,245,232,400,398,37884,7576800.0,37485,39800.0
3922,71,67,22,28,172,171,187,186,212,359,357,32164,5773438.0,31806,32040.75
3923,62,53,20,36,113,112,173,172,94,286,284,19549,2795507.0,19264,20306.0
3924,65,57,26,40,308,307,293,292,666,601,599,90244,27118322.0,89644,89999.75
3925,67,63,20,26,108,107,135,134,88,243,241,14580,1771470.0,14338,14640.75
3926,60,47,16,37,141,140,207,206,185,348,346,29187,5078538.0,28840,30102.0
3927,78,62,24,54,218,217,278,277,741,496,494,60604,15029792.0,60109,61256.0
3928,50,37,14,34,116,115,146,145,78,262,260,16936,2218616.0,16675,17030.0
3929,114,107,23,35,187,186,181,180,233,368,366,33847,6227848.0,33480,33672.0
393,29,25,7,12,127,126,110,109,75,237,235,13970,1655445.0,13734,13923.75
3930,51,44,13,23,150,149,90,89,63,240,238,13500,1620000.0,13261,14280.0
3931,79,61,29,62,388,387,303,302,1382,691,689,117564,40618362.0,116874,119024.75
3933,70,65,18,26,181,180,111,110,107,292,290,20091,2933286.0,19800,21170.0
3934,151,128,43,87,396,395,231,230,664,627,625,91476,28677726.0,90850,97968.75
3935,45,39,9,16,143,142,116,115,83,259,257,16588,2148146.0,16330,16640.75
3936,51,43,16,30,188,187,116,115,133,304,302,21808,3314816.0,21505,22952.0
3937,138,119,27,63,221,220,178,177,283,399,397,39338,7847931.0,38940,39600.75
3938,134,123,26,46,235,234,243,242,347,478,476,57105,13648095.0,56628,56882.0
394,62,34,11,64,208,207,231,230,466,439,437,48048,10546536.0,47610,47960.75
3940,43,38,10,18,139,138,147,146,145,286,284,20433,2921919.0,20148,20306.0
3941,46,41,18,26,168,167,195,194,253,363,361,32760,5945940.0,32398,32760.75
3942,65,55,19,37,407,406,326,325,1395,733,731,132682,48627953.0,131950,133955.75
3943,99,84,36,63,422,421,483,482,2407,905,903,203826,92231265.0,202922,204303.75
3944,38,32,15,24,106,105,142,141,105,248,246,15052,1866448.0,14805,15252.0
3945,66,56,19,37,175,174,244,243,496,419,417,42700,8945650.0,42282,43680.75
3946,51,45,8,18,75,74,97,96,39,172,170,7275,625650.0,7104,7310.0
3947,57,48,19,33,134,133,130,129,110,264,262,17420,2299440.0,17157,17292.0
3948,35,26,8,21,171,170,158,157,147,329,327,27018,4444461.0,26690,26895.75
395,99,82,28,59,265,264,200,199,452,465,463,53000,12322500.0,52536,53823.75
3950,78,64,26,52,425,424,349,348,1821,774,772,148325,57401775.0,147552,149382.0
3951,114,80,42,108,351,350,380,379,1617,731,729,133380,48750390.0,132650,133224.75
3952,18,17,4,4,154,153,180,179,181,334,332,27720,4629240.0,27387,27722.0
3953,24,21,7,11,76,75,166,165,72,242,240,12616,1526536.0,12375,14520.0
3954,43,36,15,24,123,122,82,81,48,205,203,10086,1033815.0,9882,10403.75
3955,29,27,14,16,187,186,177,176,242,364,362,33099,6024018.0,32736,32942.0
3956,98,97,4,4,193,192,147,146,162,340,338,28371,4823070.0,28032,28730.0
3957,39,34,10,18,126,125,234,233,222,360,358,29484,5307120.0,29125,32220.0
3958,32,24,10,20,97,96,110,109,60,207,205,10670,1104345.0,10464,10608.75
3959,30,27,11,14,149,148,339,338,303,488,486,50511,12324684.0,50024,59292.0
396,56,43,12,36,93,92,148,147,63,241,239,13764,1658562.0,13524,14399.75
3960,48,44,14,20,96,95,108,107,43,204,202,10368,1057536.0,10165,10302.0
3962,134,119,22,50,194,193,201,200,409,395,393,38994,7701315.0,38600,38808.75
3963,69,58,19,39,268,267,179,178,446,447,445,47972,10721742.0,47526,49728.75
3964,45,40,13,21,98,97,137,136,85,235,233,13426,1577555.0,13192,13688.75
3965,142,121,43,83,415,414,469,468,2802,884,882,194635,86028670.0,193752,194922.0
3966,41,37,11,16,224,223,138,137,214,362,360,30912,5595072.0,30551,32580.0
3967,103,87,29,59,183,182,205,204,288,388,386,37515,7277910.0,37128,37442.0
3969,97,87,34,52,261,260,230,229,516,491,489,60030,14737365.0,59540,60024.75
397,36,33,10,14,137,136,114,113,87,251,249,15618,1960059.0,15368,15624.75
3970,34,32,9,11,143,142,81,80,59,224,222,11583,1297296.0,11360,12432.0
3971,38,34,18,24,235,234,376,375,829,611,609,88360,26993980.0,87750,93024.75
3972,44,39,15,23,117,116,145,144,93,262,260,16965,2222415.0,16704,17030.0
3973,72,62,22,37,138,137,155,154,101,293,291,21390,3133635.0,21098,21315.75
3974,258,257,9,9,267,266,267,266,658,534,532,71289,19034163.0,70756,71022.0
3975,43,37,10,17,137,136,143,142,95,280,278,19591,2742740.0,19312,19460.0
3976,80,61,21,57,217,216,160,159,263,377,375,34720,6544720.0,34344,35343.75
3977,40,35,11,19,102,101,99,98,49,201,199,10098,1014849.0,9898,9999.75
3978,120,110,28,46,428,427,265,264,1666,693,691,113420,39300030.0,112728,119715.75
3979,63,54,19,34,145,144,120,119,148,265,263,17400,2305500.0,17136,17423.75
398,68,50,14,48,167,166,172,171,170,339,337,28724,4868718.0,28386,28560.75
3980,91,80,27,47,193,192,313,312,372,506,504,60409,15283477.0,59904,63756.0
3981,391,383,13,27,405,404,405,404,3301,810,808,164025,66430125.0,163216,163620.0
3982,82,72,20,37,126,125,171,170,116,297,295,21546,3199581.0,21250,21903.75
3984,57,49,18,32,114,113,184,183,139,298,296,20976,3125424.0,20679,22052.0
3985,37,34,8,11,92,91,73,72,29,165,163,6716,554070.0,6552,6723.75
3986,56,43,17,41,219,218,136,135,177,355,353,29784,5286660.0,29430,31328.75
3987,63,51,20,42,253,252,249,248,442,502,500,62997,15812247.0,62496,62750.0
3988,53,47,13,23,126,125,136,135,109,262,260,17136,2244816.0,16875,17030.0
3989,50,38,14,36,109,108,177,176,94,286,284,19293,2758899.0,19008,20306.0
399,94,82,30,52,215,214,162,161,204,377,375,34830,6565455.0,34454,35343.75
3990,22,19,6,9,212,211,136,135,157,348,346,28832,5016768.0,28485,30102.0
3991,23,20,10,14,160,159,209,208,197,369,367,33440,6169680.0,33072,33855.75
3992,117,100,36,67,267,266,357,356,868,624,622,95319,29739528.0,94696,97032.0
3993,86,66,20,57,183,182,267,266,565,450,448,48861,10993725.0,48412,50400.0
3994,46,39,15,27,171,170,136,135,169,307,305,23256,3569796.0,22950,23408.75
3995,90,84,20,30,157,156,156,155,143,313,311,24492,3832998.0,24180,24335.75
3996,33,26,9,19,180,179,98,97,68,278,276,17640,2451960.0,17363,19182.0
3997,94,76,29,59,319,318,510,509,2181,829,827,162690,67435005.0,161862,171395.75
3998,38,35,13,17,128,127,108,107,70,236,234,13824,1631232.0,13589,13806.0
3999,81,61,30,66,253,252,281,280,657,534,532,71093,18981831.0,70560,71022.0
4,60,52,14,27,115,114,175,174,95,290,288,20125,2918125.0,19836,20880.0
40,52,42,13,30,118,117,97,96,63,215,213,11446,1230445.0,11232,11448.75
400,65,52,19,41,131,130,116,115,82,247,245,15196,1876706.0,14950,15128.75
4000,48,36,16,38,105,104,130,129,69,235,233,13650,1603875.0,13416,13688.75
4001,51,43,14,28,156,155,128,127,128,284,282,19968,2835456.0,19685,20022.0
4002,51,37,17,40,120,119,116,115,77,236,234,13920,1642560.0,13685,13806.0
4003,64,52,18,36,146,145,165,164,260,311,309,24090,3745995.0,23780,24024.75
4004,50,37,13,37,110,109,126,125,63,236,234,13860,1635480.0,13625,13806.0
4005,95,82,35,59,331,330,263,262,748,594,592,87053,25854741.0,86460,87912.0
4006,80,62,27,60,179,178,239,238,394,418,416,42781,8941229.0,42364,43472.0
4007,107,93,21,45,208,207,149,148,187,357,355,30992,5532072.0,30636,31683.75
4008,208,171,62,133,404,403,469,468,3076,873,871,189476,82706274.0,188604,190095.75
4009,43,35,10,22,140,139,90,89,57,230,228,12600,1449000.0,12371,13110.0
401,29,27,10,12,114,113,103,102,46,217,215,11742,1274007.0,11526,11663.75
4010,45,39,18,26,159,158,165,164,152,324,322,26235,4250070.0,25912,26082.0
4011,32,29,11,15,152,151,188,187,142,340,338,28576,4857920.0,28237,28730.0
4012,60,52,22,35,149,148,130,129,102,279,277,19370,2702115.0,19092,19320.75
4013,77,47,17,74,342,341,207,206,1015,549,547,70794,19432953.0,70246,75075.75
4014,92,87,22,28,157,156,145,144,123,302,300,22765,3437515.0,22464,22650.0
4015,46,42,15,19,253,252,215,214,469,468,466,54395,12728430.0,53928,54522.0
4016,103,95,24,38,217,216,203,202,418,420,418,44051,9250710.0,43632,43890.0
4017,41,32,11,27,186,185,134,133,126,320,318,24924,3987840.0,24605,25440.0
4018,52,43,17,33,146,145,248,247,249,394,392,36208,7132976.0,35815,38612.0
4019,39,37,11,13,183,182,208,207,217,391,389,38064,7441512.0,37674,38024.75
402,38,34,14,20,229,228,244,243,387,473,471,55876,13214674.0,55404,55695.75
4020,48,39,17,33,206,205,187,186,235,393,391,38522,7569573.0,38130,38415.75
4021,38,34,12,17,92,91,177,176,89,269,267,16284,2190198.0,16016,17955.75
4022,36,31,9,15,113,112,91,90,46,204,202,10283,1048866.0,10080,10302.0
4023,84,68,27,54,254,253,298,297,1157,552,550,75692,20890992.0,75141,75900.0
4024,28,23,11,19,260,259,267,266,584,527,525,69420,18292170.0,68894,69168.75
4025,74,64,22,40,121,120,185,184,152,306,304,22385,3424905.0,22080,23256.0
4026,159,131,46,100,335,334,288,287,893,623,621,96480,30053520.0,95858,96720.75
4027,46,36,15,33,258,257,109,108,212,367,365,28122,5160387.0,27756,33488.75
4028,89,79,20,38,165,164,189,188,213,354,352,31185,5519745.0,30832,31152.0
4029,81,66,18,42,149,148,236,235,268,385,383,35164,6769070.0,34780,36863.75
403,57,51,13,20,119,118,123,122,81,242,240,14637,1771077.0,14396,14520.0
4031,75,59,26,56,208,207,307,306,490,515,513,63856,16442920.0,63342,66048.75
4032,49,33,15,36,128,127,129,128,92,257,255,16512,2121792.0,16256,16383.75
4033,203,201,16,18,308,307,354,353,2402,662,660,109032,36089592.0,108371,109230.0
4035,48,40,16,30,134,133,108,107,91,242,240,14472,1751112.0,14231,14520.0
4036,48,42,9,17,137,136,145,144,166,282,280,19865,2800965.0,19584,19740.0
4037,33,28,11,18,85,84,174,173,80,259,257,14790,1915305.0,14532,16640.75
4039,25,23,10,11,270,269,162,161,262,432,430,43740,9447840.0,43309,46440.0
404,35,32,11,14,86,85,118,117,39,204,202,10148,1035096.0,9945,10302.0
4040,90,74,26,56,245,244,319,318,556,564,562,78155,22039710.0,77592,79242.0
4041,44,38,12,19,150,149,71,70,49,221,219,10650,1176825.0,10430,12099.75
4042,84,73,23,43,221,220,137,136,150,358,356,30277,5419583.0,29920,31862.0
4043,80,68,27,49,161,160,161,160,230,322,320,25921,4173281.0,25600,25760.0
4044,65,60,13,21,104,103,91,90,62,195,193,9464,922740.0,9270,9408.75
4045,59,55,11,15,82,81,103,102,37,185,183,8446,781255.0,8262,8463.75
4046,40,27,12,34,102,101,189,188,142,291,289,19278,2804949.0,18988,21024.75
4047,19,17,7,8,180,179,104,103,90,284,282,18720,2658240.0,18437,20022.0
4048,98,97,4,4,193,192,124,123,126,317,315,23932,3793222.0,23616,24963.75
4049,47,38,13,26,139,138,121,120,116,260,258,16819,2186470.0,16560,16770.0
405,71,61,20,38,140,139,221,220,259,361,359,30940,5584670.0,30580,32399.75
4050,28,24,7,10,187,186,309,308,394,496,494,57783,14330184.0,57288,61256.0
4051,53,44,13,24,150,149,270,269,315,420,418,40500,8505000.0,40081,43890.0
4052,72,58,18,43,129,128,232,231,167,361,359,29928,5402004.0,29568,32399.75
4053,76,59,26,58,205,204,169,168,248,374,372,34645,6478615.0,34272,34782.0
4054,252,234,41,75,514,513,323,322,4103,837,835,166022,69480207.0,165186,174723.75
4055,41,38,14,16,175,174,124,123,116,299,297,21700,3244150.0,21402,22200.75
4056,46,40,13,21,170,169,83,82,87,253,251,14110,1784915.0,13858,15875.75
4057,79,70,31,46,171,170,172,171,269,343,341,29412,5044158.0,29070,29240.75
4058,77,59,31,63,285,284,246,245,574,531,529,70110,18614205.0,69580,70224.75
4059,56,43,17,40,157,156,234,233,279,391,389,36738,7182279.0,36348,38024.75
406,83,66,26,57,168,167,201,200,206,369,367,33768,6230196.0,33400,33855.75
4060,66,55,22,41,214,213,187,186,450,401,399,40018,8023609.0,39618,39999.75
4061,42,36,15,25,184,183,199,198,230,383,381,36616,7011964.0,36234,36480.75
4062,134,112,47,89,520,519,268,267,1221,788,786,139360,54907840.0,138573,154842.0
4063,55,48,15,27,160,159,154,153,144,314,312,24640,3868480.0,24327,24492.0
4064,105,89,39,68,473,472,281,280,1381,754,752,132913,50108201.0,132160,141752.0
4065,30,28,6,8,124,123,102,101,63,226,224,12648,1429224.0,12423,12656.0
4066,82,74,21,34,184,183,141,140,151,325,323,25944,4215900.0,25620,26243.75
4067,80,62,17,49,176,175,148,147,154,324,322,26048,4219776.0,25725,26082.0
4068,65,57,10,22,158,157,99,98,83,257,255,15642,2009997.0,15386,16383.75
4069,59,51,11,24,171,170,88,87,122,259,257,15048,1948716.0,14790,16640.75
407,55,51,15,21,153,152,89,88,90,242,240,13617,1647657.0,13376,14520.0
4070,45,37,11,25,170,169,140,139,152,310,308,23800,3689000.0,23491,23870.0
4071,33,30,11,14,159,158,115,114,96,274,272,18285,2505045.0,18012,18632.0
4072,72,58,24,48,522,521,341,340,3879,863,861,178002,76807863.0,177140,185760.75
4073,29,27,7,9,177,176,85,84,70,262,260,15045,1970895.0,14784,17030.0
4074,40,33,13,24,292,291,163,162,440,455,453,47596,10828090.0,47142,51528.75
4075,29,27,13,14,175,174,264,263,369,439,437,46200,10140900.0,45762,47960.75
4076,25,20,5,12,148,147,97,96,134,245,243,14356,1758610.0,14112,14883.75
4077,105,94,26,46,324,323,381,380,1384,705,703,123444,43514010.0,122740,123903.75
4078,58,51,19,31,85,84,224,223,113,309,307,19040,2941680.0,18732,23715.75
4079,41,35,11,19,164,163,101,100,108,265,263,16564,2194730.0,16300,17423.75
408,30,23,11,23,163,162,94,93,81,257,255,15322,1968877.0,15066,16383.75
4080,109,94,29,57,186,185,244,243,307,430,428,45384,9757560.0,44955,46010.0
4081,61,56,16,22,152,151,304,303,345,456,454,46208,10535424.0,45753,51756.0
4082,36,22,8,34,96,95,102,101,49,198,196,9792,969408.0,9595,9702.0
4083,75,54,27,66,183,182,196,195,295,379,377,35868,6796986.0,35490,35720.75
4084,41,33,12,26,112,111,176,175,129,288,286,19712,2838528.0,19425,20592.0
4085,56,52,18,22,142,141,170,169,134,312,310,24140,3765840.0,23829,24180.0
4086,79,68,18,38,167,166,175,174,232,342,340,29225,4997475.0,28884,29070.0
4087,68,43,20,68,428,427,221,220,1044,649,647,94588,30693806.0,93940,104975.75
4088,43,35,16,28,257,256,220,219,417,477,475,56540,13484790.0,56064,56643.75
4089,111,96,30,58,217,216,256,255,633,473,471,55552,13138048.0,55080,55695.75
409,81,73,24,38,330,329,422,421,1402,752,750,139260,52361760.0,138509,141000.0
4090,53,34,16,52,134,133,126,125,97,260,258,16884,2194920.0,16625,16770.0
4093,55,45,16,27,174,173,100,99,128,274,272,17400,2383800.0,17127,18632.0
4094,44,22,9,49,141,140,166,165,180,307,305,23406,3592821.0,23100,23408.75
4095,135,106,41,95,320,319,324,323,1019,644,642,103680,33384960.0,103037,103362.0
4096,52,46,12,22,156,155,120,119,117,276,274,18720,2583360.0,18445,18906.0
4097,42,35,13,23,142,141,134,133,109,276,274,19028,2625864.0,18753,18906.0
4098,156,128,61,114,546,545,516,515,6725,1062,1060,281736,149601816.0,280675,281430.0
4099,51,44,13,25,146,145,97,96,93,243,241,14162,1720683.0,13920,14640.75
41,136,109,36,85,455,454,451,450,2138,906,904,205205,92957865.0,204300,204756.0
410,55,40,22,48,225,224,152,151,235,377,375,34200,6446700.0,33824,35343.75
4100,35,31,10,16,88,87,148,147,105,236,234,13024,1536832.0,12789,13806.0
4101,82,74,15,28,126,125,113,112,74,239,237,14238,1701441.0,14000,14160.75
4102,81,69,26,48,201,200,168,167,201,369,367,33768,6230196.0,33400,33855.75
4104,51,46,8,16,208,207,95,94,109,303,301,19760,2993640.0,19458,22800.75
4105,41,35,13,18,187,186,196,195,289,383,381,36652,7018858.0,36270,36480.75
4106,43,37,17,26,155,154,413,412,701,568,566,64015,18180260.0,63448,80372.0
4107,34,29,14,22,125,124,81,80,43,206,204,10125,1042875.0,9920,10506.0
4108,51,43,16,27,157,156,187,186,130,344,342,29359,5049748.0,29016,29412.0
4109,391,383,13,27,405,404,405,404,3294,810,808,164025,66430125.0,163216,163620.0
411,71,62,23,37,237,236,335,334,709,572,570,79395,22706970.0,78824,81510.0
4110,49,35,14,36,166,165,384,383,521,550,548,63744,17529600.0,63195,75350.0
4111,36,27,9,25,155,154,103,102,133,258,256,15965,2059485.0,15708,16512.0
4112,71,58,22,46,181,180,159,158,219,340,338,28779,4892430.0,28440,28730.0
4113,40,33,11,23,111,110,90,89,41,201,199,9990,1003995.0,9790,9999.75
4114,58,48,20,38,312,311,181,180,617,493,491,56472,13920348.0,55980,60515.75
4115,73,62,28,48,300,299,214,213,474,514,512,64200,16499400.0,63687,65792.0
4116,69,55,24,50,448,447,443,442,2393,891,889,198464,88415712.0,197574,198024.75
4117,118,106,20,42,173,172,146,145,173,319,317,25258,4028651.0,24940,25280.75
4118,103,85,27,61,201,200,234,233,358,435,433,47034,10229895.0,46600,47088.75
4119,40,29,10,23,131,130,120,119,90,251,249,15720,1972860.0,15470,15624.75
412,97,86,30,48,506,505,327,326,2531,833,831,165462,68914923.0,164630,173055.75
4120,52,45,19,29,180,179,187,186,359,367,365,33660,6176610.0,33294,33488.75
4121,45,38,10,20,130,129,151,150,121,281,279,19630,2758015.0,19350,19599.75
4122,110,104,12,21,216,215,178,177,308,394,392,38448,7574256.0,38055,38612.0
4123,74,66,14,26,143,142,140,139,124,283,281,20020,2832830.0,19738,19880.75
4125,125,116,20,33,193,192,236,235,374,429,427,45548,9770046.0,45120,45795.75
4126,66,54,18,40,251,250,137,136,225,388,386,34387,6671078.0,34000,37442.0
4127,55,44,19,39,188,187,222,221,402,410,408,41736,8555880.0,41327,41820.0
4128,46,42,17,23,202,201,165,164,218,367,365,33330,6116055.0,32964,33488.75
4129,31,26,9,16,151,150,146,145,140,297,295,22046,3273831.0,21750,21903.75
413,73,59,21,46,161,160,132,131,97,293,291,21252,3113418.0,20960,21315.75
4130,38,23,11,37,121,120,178,177,150,299,297,21538,3219931.0,21240,22200.75
4131,54,40,19,35,198,197,262,261,568,460,458,51876,11931480.0,51417,52670.0
4132,72,69,8,12,118,117,99,98,81,217,215,11682,1267497.0,11466,11663.75
4133,42,33,8,24,174,173,164,163,346,338,336,28536,4822584.0,28199,28392.0
4134,35,34,8,8,196,195,263,262,378,459,457,51548,11830266.0,51090,52440.75
4135,56,47,15,31,161,160,106,105,87,267,265,17066,2278311.0,16800,17688.75
4136,46,37,14,28,158,157,139,138,96,297,295,21962,3261357.0,21666,21903.75
4137,57,50,17,28,174,173,199,198,306,373,371,34626,6457749.0,34254,34595.75
4138,171,144,49,99,495,494,310,309,1893,805,803,153450,61763625.0,152646,161603.75
4139,43,38,13,20,156,155,145,144,102,301,299,22620,3404310.0,22320,22499.75
414,38,36,11,12,141,140,229,228,210,370,368,32289,5973465.0,31920,34040.0
4140,63,55,11,24,199,198,282,281,674,481,479,56118,13496379.0,55638,57599.75
4141,65,52,17,41,125,124,117,116,67,242,240,14625,1769625.0,14384,14520.0
4142,135,132,8,12,170,169,147,146,138,317,315,24990,3960915.0,24674,24963.75
4143,65,59,19,29,464,463,249,248,1395,713,711,115536,41188584.0,114824,126735.75
4144,34,30,9,14,89,88,99,98,39,188,186,8811,828234.0,8624,8742.0
4145,21,16,6,11,261,260,119,118,198,380,378,31059,5901210.0,30680,35910.0
4146,21,18,8,12,87,86,94,93,35,181,179,8178,740109.0,7998,8099.75
4147,124,94,41,95,283,282,286,285,771,569,567,80938,23026861.0,80370,80655.75
4148,35,26,13,28,191,190,231,230,344,422,420,44121,9309531.0,43700,44310.0
4149,74,58,22,48,149,148,143,142,165,292,290,21307,3110822.0,21016,21170.0
415,48,37,16,36,160,159,106,105,80,266,264,16960,2255680.0,16695,17556.0
4150,257,256,10,10,267,266,267,266,601,534,532,71289,19034163.0,70756,71022.0
4151,86,67,30,63,287,286,249,248,585,536,534,71463,19152084.0,70928,71556.0
4153,27,25,9,11,161,160,118,117,110,279,277,18998,2650221.0,18720,19320.75
4154,41,33,14,25,141,140,177,176,149,318,316,24957,3968163.0,24640,25122.0
4155,77,71,14,24,95,94,113,112,51,208,206,10735,1116440.0,10528,10712.0
4156,126,102,44,89,474,473,306,305,1604,780,778,145044,56567160.0,144265,151710.0
4157,41,30,11,28,262,261,221,220,354,483,481,57902,13983333.0,57420,58080.75
4158,62,53,13,29,254,253,372,371,683,626,624,94488,29574744.0,93863,97656.0
4159,119,98,39,78,194,193,345,344,431,539,537,66930,18037635.0,66392,72360.75
416,93,75,31,65,183,182,289,288,366,472,470,52887,12481332.0,52416,55460.0
4160,52,42,17,33,131,130,128,127,104,259,257,16768,2171456.0,16510,16640.75
4161,66,50,17,46,287,286,177,176,340,464,462,50799,11785368.0,50336,53592.0
4162,48,34,15,39,127,126,107,106,69,234,232,13589,1589913.0,13356,13572.0
4163,116,99,38,67,303,302,372,371,1323,675,673,112716,38041650.0,112042,113568.75
4164,47,39,12,26,137,136,154,153,117,291,289,21098,3069759.0,20808,21024.75
4165,63,57,17,27,142,141,190,189,212,332,330,26980,4478680.0,26649,27390.0
4166,74,66,18,32,122,121,136,135,97,258,256,16592,2140368.0,16335,16512.0
4167,95,72,29,73,182,181,198,197,315,380,378,36036,6846840.0,35657,35910.0
4168,49,41,12,24,168,167,161,160,176,329,327,27048,4449396.0,26720,26895.75
4169,57,47,16,34,194,193,291,290,480,485,483,56454,13690095.0,55970,58563.75
417,73,55,18,51,207,206,163,162,237,370,368,33741,6242085.0,33372,34040.0
4170,50,43,14,24,119,118,110,109,85,229,227,13090,1498805.0,12862,12995.75
4171,63,57,18,26,96,95,194,193,96,290,288,18624,2700480.0,18335,20880.0
4172,32,30,7,9,185,184,109,108,92,294,292,20165,2964255.0,19872,21462.0
4173,53,48,15,23,195,194,152,151,197,347,345,29640,5142540.0,29294,29928.75
4174,44,39,15,21,216,215,203,202,307,419,417,43848,9186156.0,43430,43680.75
4175,67,37,23,80,221,220,174,173,363,395,393,38454,7594665.0,38060,38808.75
4176,91,75,32,58,228,227,228,227,381,456,454,51984,11852352.0,51529,51756.0
4177,50,44,13,23,197,196,113,112,114,310,308,22261,3450455.0,21952,23870.0
4178,257,256,10,10,267,266,267,266,604,534,532,71289,19034163.0,70756,71022.0
4179,78,68,19,37,150,149,195,194,209,345,343,29250,5045625.0,28906,29583.75
4180,45,37,17,30,262,261,156,155,373,418,416,40872,8542248.0,40455,43472.0
4181,20,19,6,6,122,121,64,63,35,186,184,7808,726144.0,7623,8556.0
4182,80,71,24,36,190,189,157,156,266,347,345,29830,5175505.0,29484,29928.75
4183,48,40,12,20,142,141,116,115,77,258,256,16472,2124888.0,16215,16512.0
4184,38,32,12,22,72,71,100,99,41,172,170,7200,619200.0,7029,7310.0
4185,56,49,18,29,168,167,167,166,161,335,333,28056,4699380.0,27722,27888.75
4186,37,33,13,18,335,334,170,169,336,505,503,56950,14379875.0,56446,63503.75
4187,64,55,19,35,157,156,143,142,127,300,298,22451,3367650.0,22152,22350.0
4188,108,90,29,60,251,250,308,307,543,559,557,77308,21607586.0,76750,77840.75
4189,70,63,23,35,193,192,191,190,228,384,382,36863,7077696.0,36480,36672.0
419,40,37,7,11,97,96,110,109,38,207,205,10670,1104345.0,10464,10608.75
4190,99,80,43,79,355,354,236,235,761,591,589,83780,24756990.0,83190,87024.75
4191,258,257,9,9,267,266,267,266,667,534,532,71289,19034163.0,70756,71022.0
4192,68,57,25,45,175,174,274,273,337,449,447,47950,10764775.0,47502,50175.75
4193,33,30,7,11,103,102,153,152,88,256,254,15759,2017152.0,15504,16256.0
4194,75,61,30,56,237,236,193,192,400,430,428,45741,9834315.0,45312,46010.0
4195,44,38,11,20,145,144,211,210,407,356,354,30595,5445910.0,30240,31506.0
4196,70,58,26,42,216,215,201,200,317,417,415,43416,9052236.0,43000,43263.75
4197,55,50,16,24,137,136,181,180,130,318,316,24797,3942723.0,24480,25122.0
4198,74,65,20,36,383,382,222,221,1140,605,603,85026,25720365.0,84422,91203.75
4199,68,60,22,35,149,148,190,189,169,339,337,28310,4798545.0,27972,28560.75
42,68,60,21,35,188,187,171,170,218,359,357,32148,5770566.0,31790,32040.75
420,100,93,29,41,170,169,206,205,275,376,374,35020,6583760.0,34645,35156.0
4200,39,33,13,23,105,104,189,188,100,294,292,19845,2917215.0,19552,21462.0
4201,30,28,8,10,143,142,81,80,68,224,222,11583,1297296.0,11360,12432.0
4202,90,77,37,59,247,246,466,465,1239,713,711,115102,41033863.0,114390,126735.75
4203,29,24,8,13,185,184,119,118,121,304,302,22015,3346280.0,21712,22952.0
4204,25,23,8,10,100,99,215,214,119,315,313,21500,3386250.0,21186,24648.75
4205,119,98,33,72,248,247,259,258,592,507,505,64232,16282812.0,63726,64008.75
4206,85,70,27,53,338,337,190,189,428,528,526,64220,16954080.0,63693,69432.0
4207,42,41,12,12,82,81,84,83,47,166,164,6888,571704.0,6723,6806.0
4208,39,35,13,19,297,296,169,168,499,466,464,50193,11694969.0,49728,54056.0
4209,75,61,22,46,191,190,251,250,353,442,440,47941,10594961.0,47500,48620.0
421,97,82,27,54,289,288,189,188,437,478,476,54621,13054419.0,54144,56882.0
4210,55,49,13,21,175,174,120,119,106,295,293,21000,3097500.0,20706,21608.75
4211,109,91,33,66,188,187,213,212,240,401,399,40044,8028822.0,39644,39999.75
4212,91,74,28,60,346,345,298,297,857,644,642,103108,33200776.0,102465,103362.0
4213,31,27,6,12,85,84,85,84,27,170,168,7225,614125.0,7056,7140.0
4214,26,23,9,12,178,177,173,172,194,351,349,30794,5404347.0,30444,30624.75
4215,121,104,40,71,256,255,199,198,506,455,453,50944,11589760.0,50490,51528.75
4216,98,97,4,4,101,100,147,146,73,248,246,14847,1841028.0,14600,15252.0
4217,118,103,35,63,395,394,260,259,949,655,653,102700,33634250.0,102046,106928.75
4218,45,44,11,11,85,84,152,151,83,237,235,12920,1531020.0,12684,13923.75
4219,52,47,12,19,98,97,127,126,60,225,223,12446,1400175.0,12222,12543.75
422,77,67,19,37,220,219,267,266,478,487,485,58740,14303190.0,58254,59048.75
4220,84,79,25,32,207,206,155,154,191,362,360,32085,5807385.0,31724,32580.0
4221,79,60,15,41,188,187,171,170,241,359,357,32148,5770566.0,31790,32040.75
4222,27,23,12,18,151,150,164,163,119,315,313,24764,3900330.0,24450,24648.75
4223,46,37,10,19,102,101,144,143,72,246,244,14688,1806624.0,14443,15006.0
4224,37,31,13,23,156,155,109,108,85,265,263,17004,2253030.0,16740,17423.75
4225,35,28,9,18,98,97,144,143,100,242,240,14112,1707552.0,13871,14520.0
4226,80,69,15,28,160,159,158,157,166,318,316,25280,4019520.0,24963,25122.0
4227,78,76,18,20,118,117,193,192,153,311,309,22774,3541357.0,22464,24024.75
4228,49,36,12,30,191,190,163,162,234,354,352,31133,5510541.0,30780,31152.0
4229,58,49,14,30,103,102,113,112,57,216,214,11639,1257012.0,11424,11556.0
423,55,47,17,31,177,176,120,119,121,297,295,21240,3154140.0,20944,21903.75
4230,91,75,28,58,168,167,195,194,214,363,361,32760,5945940.0,32398,32760.75
4231,67,55,22,43,276,275,239,238,508,515,513,65964,16985730.0,65450,66048.75
4232,29,26,10,14,75,74,233,232,135,308,306,17475,2691150.0,17168,23562.0
4233,59,49,15,33,119,118,163,162,125,282,280,19397,2734977.0,19116,19740.0
4234,33,27,10,20,204,203,123,122,145,327,325,25092,4102542.0,24766,26568.75
4235,49,31,10,44,128,127,99,98,96,227,225,12672,1438272.0,12446,12768.75
4236,89,63,27,76,226,225,262,261,530,488,486,59212,14447728.0,58725,59292.0
4237,60,45,19,45,125,124,159,158,135,284,282,19875,2822250.0,19592,20022.0
4238,34,27,12,18,157,156,193,192,239,350,348,30301,5302675.0,29952,30450.0
4239,27,19,7,21,90,89,114,113,60,204,202,10260,1046520.0,10057,10302.0
424,48,40,11,25,171,170,340,339,525,511,509,58140,14854770.0,57630,65024.75
4240,77,57,27,62,250,249,338,337,913,588,586,84500,24843000.0,83913,86142.0
4241,85,67,28,62,179,178,192,191,272,371,369,34368,6375264.0,33998,34224.75
4242,46,40,14,22,226,225,155,154,278,381,379,35030,6673215.0,34650,36099.75
4243,46,39,16,26,368,367,220,219,861,588,586,80960,23802240.0,80373,86142.0
4244,151,108,41,125,277,276,260,259,779,537,535,72020,19337370.0,71484,71823.75
4245,66,41,12,60,159,158,149,148,217,308,306,23691,3648414.0,23384,23562.0
4246,57,51,12,22,203,202,215,214,354,418,416,43645,9121805.0,43228,43472.0
4247,45,42,13,16,151,150,117,116,80,268,266,17667,2367378.0,17400,17822.0
4248,110,105,11,18,262,261,178,177,368,440,438,46636,10259920.0,46197,48180.0
4249,79,68,22,40,184,183,187,186,286,371,369,34408,6382684.0,34038,34224.75
425,153,138,42,69,460,459,265,264,1455,725,723,121900,44188750.0,121176,131043.75
4250,72,55,18,50,138,137,137,136,103,275,273,18906,2599575.0,18632,18768.75
4251,59,49,19,36,107,106,235,234,154,342,340,25145,4299795.0,24804,29070.0
4252,89,79,32,48,167,166,177,176,170,344,342,29559,5084148.0,29216,29412.0
4253,38,33,11,19,101,100,114,113,62,215,213,11514,1237755.0,11300,11448.75
4254,89,79,14,31,145,144,258,257,304,403,401,37410,7538115.0,37008,40400.75
4255,49,40,16,30,152,151,184,183,170,336,334,27968,4698624.0,27633,28056.0
4256,73,56,21,51,138,137,133,132,141,271,269,18354,2486967.0,18084,18224.75
4257,31,28,10,13,105,104,130,129,68,235,233,13650,1603875.0,13416,13688.75
4258,33,22,9,29,117,116,126,125,105,243,241,14742,1791153.0,14500,14640.75
4259,55,46,18,30,192,191,128,127,123,320,318,24576,3932160.0,24257,25440.0
426,51,44,12,24,151,150,125,124,123,276,274,18875,2604750.0,18600,18906.0
4260,33,25,11,20,136,135,110,109,78,246,244,14960,1840080.0,14715,15006.0
4261,34,28,15,24,121,120,341,340,321,462,460,41261,9531291.0,40800,53130.0
4262,70,57,25,47,223,222,256,255,610,479,477,57088,13672576.0,56610,57120.75
4263,44,39,13,20,231,230,141,140,297,372,370,32571,6058206.0,32200,34410.0
4264,257,256,10,10,267,266,267,266,605,534,532,71289,19034163.0,70756,71022.0
4265,74,67,14,26,151,150,95,94,64,246,244,14345,1764435.0,14100,15006.0
4266,79,63,27,55,170,169,331,330,510,501,499,56270,14095635.0,55770,62499.75
4267,35,29,12,22,229,228,171,170,269,400,398,39159,7831800.0,38760,39800.0
4268,89,77,23,45,208,207,223,222,330,431,429,46384,9995752.0,45954,46224.75
4269,39,33,6,14,142,141,86,85,79,228,226,12212,1392168.0,11985,12882.0
427,73,64,24,38,136,135,172,171,152,308,306,23392,3602368.0,23085,23562.0
4270,29,23,8,18,144,143,213,212,215,357,355,30672,5474952.0,30316,31683.75
4271,40,33,13,24,168,167,259,258,319,427,425,43512,9289812.0,43086,45368.75
4272,86,67,24,60,358,357,168,167,736,526,524,60144,15817872.0,59619,68906.0
4273,53,44,14,25,240,239,244,243,514,484,482,58560,14171520.0,58077,58322.0
4274,80,66,24,49,171,170,162,161,189,333,331,27702,4612383.0,27370,27555.75
4275,86,68,23,57,136,135,154,153,116,290,288,20944,3036880.0,20655,20880.0
4276,123,100,44,87,289,288,451,450,1740,740,738,130339,48225430.0,129600,136530.0
4277,34,31,13,17,195,194,163,162,236,358,356,31785,5689515.0,31428,31862.0
4278,35,28,12,22,189,188,184,183,277,373,371,34776,6485724.0,34404,34595.75
4279,168,152,62,91,470,469,361,360,3098,831,829,169670,70497885.0,168840,172224.75
428,37,30,11,21,132,131,162,161,126,294,292,21384,3143448.0,21091,21462.0
4280,71,58,22,44,179,178,111,110,127,290,288,19869,2881005.0,19580,20880.0
4281,34,20,8,28,86,85,131,130,69,217,215,11266,1222361.0,11050,11663.75
4282,87,78,27,41,186,185,200,199,325,386,384,37200,7179600.0,36815,37056.0
4283,44,41,11,15,83,82,118,117,46,201,199,9794,984297.0,9594,9999.75
4284,37,29,10,22,192,191,155,154,194,347,345,29760,5163360.0,29414,29928.75
4285,169,137,42,101,288,287,319,318,795,607,605,91872,27883152.0,91266,91808.75
4286,43,37,13,23,115,114,204,203,180,319,317,23460,3741870.0,23142,25280.75
4287,52,42,16,34,96,95,106,105,49,202,200,10176,1027776.0,9975,10100.0
4288,105,95,30,47,199,198,343,342,495,542,540,68257,18497647.0,67716,73170.0
4289,37,28,11,27,150,149,112,111,89,262,260,16800,2200800.0,16539,17030.0
429,75,59,27,51,203,202,270,269,501,473,471,54810,12962565.0,54338,55695.75
4290,38,32,13,22,172,171,242,241,307,414,412,41624,8616168.0,41211,42642.0
4291,38,29,10,24,124,123,119,118,97,243,241,14756,1792854.0,14514,14640.75
4292,69,56,18,39,132,131,211,210,171,343,341,27852,4776618.0,27510,29240.75
4293,62,49,19,43,178,177,127,126,166,305,303,22606,3447415.0,22302,23103.75
4294,70,64,18,28,129,128,130,129,81,259,257,16770,2171715.0,16512,16640.75
4295,40,35,13,21,165,164,91,90,63,256,254,15015,1921920.0,14760,16256.0
4296,278,272,26,36,506,505,303,302,2462,809,807,153318,62017131.0,152510,163215.75
4297,54,44,17,35,244,243,215,214,423,459,457,52460,12039570.0,52002,52440.75
4298,36,32,12,18,92,91,354,353,272,446,444,32568,7262664.0,32123,49506.0
4299,31,30,6,6,88,87,107,106,40,195,193,9416,918060.0,9222,9408.75
43,49,44,19,26,210,209,246,245,357,456,454,51660,11778480.0,51205,51756.0
430,55,44,19,36,119,118,182,181,131,301,299,21658,3259529.0,21358,22499.75
4300,45,33,12,34,245,244,156,155,287,401,399,38220,7663110.0,37820,39999.75
4301,37,31,10,15,201,200,185,184,282,386,384,37185,7176705.0,36800,37056.0
4302,144,105,31,105,434,433,392,391,2259,826,824,170128,70262864.0,169303,170156.0
4303,61,51,19,35,158,157,181,180,248,339,337,28598,4847361.0,28260,28560.75
4304,85,75,22,40,164,163,126,125,124,290,288,20664,2996280.0,20375,20880.0
4305,76,65,28,46,254,253,161,160,293,415,413,40894,8485505.0,40480,42848.75
4306,51,38,16,36,127,126,91,90,64,218,216,11557,1259713.0,11340,11772.0
4307,32,22,12,30,259,258,234,233,489,493,491,60606,14939379.0,60114,60515.75
4308,38,35,13,17,194,193,132,131,135,326,324,25608,4174104.0,25283,26406.0
4309,106,99,26,37,163,162,216,215,280,379,377,35208,6671916.0,34830,35720.75
431,69,64,19,25,305,304,144,143,364,449,447,43920,9860040.0,43472,50175.75
4311,52,42,15,32,244,243,129,128,177,373,371,31476,5870274.0,31104,34595.75
4312,133,105,41,94,368,367,489,488,2153,857,855,179952,77109432.0,179096,183183.75
4313,65,54,12,32,185,184,120,119,213,305,303,22200,3385500.0,21896,23103.75
4314,40,35,11,17,138,137,125,124,102,263,261,17250,2268375.0,16988,17160.75
4315,59,51,8,18,103,102,147,146,83,250,248,15141,1892625.0,14892,15500.0
4316,54,40,11,37,95,94,129,128,102,224,222,12255,1372560.0,12032,12432.0
4317,71,61,22,39,144,143,188,187,224,332,330,27072,4493952.0,26741,27390.0
4318,117,95,37,77,352,351,253,252,937,605,603,89056,26939440.0,88452,91203.75
4319,20,17,7,9,111,110,222,221,128,333,331,24642,4102893.0,24310,27555.75
432,64,47,19,49,129,128,123,122,77,252,250,15867,1999242.0,15616,15750.0
4320,23,21,7,9,159,158,251,250,301,410,408,39909,8181345.0,39500,41820.0
4321,73,61,17,39,167,166,163,162,159,330,328,27221,4491465.0,26892,27060.0
4322,37,31,11,18,117,116,140,139,82,257,255,16380,2104830.0,16124,16383.75
4323,55,43,17,39,203,202,138,137,125,341,339,28014,4776387.0,27674,28899.75
4325,49,37,13,26,205,204,168,167,234,373,371,34440,6423060.0,34068,34595.75
4326,47,42,19,26,170,169,251,250,268,421,419,42670,8982035.0,42250,44099.75
4327,111,91,32,70,320,319,306,305,995,626,624,97920,30648960.0,97295,97656.0
4328,56,42,12,38,98,97,133,132,82,231,229,13034,1505427.0,12804,13224.75
4329,51,43,15,28,213,212,142,141,179,355,353,30246,5368665.0,29892,31328.75
433,66,53,16,36,124,123,147,146,116,271,269,18228,2469894.0,17958,18224.75
4330,47,32,12,40,206,205,167,166,310,373,371,34402,6415973.0,34030,34595.75
4331,83,79,12,18,117,116,120,119,75,237,235,14040,1663740.0,13804,13923.75
4332,35,30,15,21,321,320,494,493,2539,815,813,158574,64618905.0,157760,165648.75
4333,78,66,32,50,286,285,189,188,507,475,473,54054,12837825.0,53580,56168.75
4334,76,64,26,48,265,264,229,228,412,494,492,60685,14989195.0,60192,60762.0
4335,51,36,10,33,130,129,117,116,93,247,245,15210,1878435.0,14964,15128.75
4336,47,43,10,16,116,115,88,87,48,204,202,10208,1041216.0,10005,10302.0
4337,31,25,9,16,164,163,293,292,517,457,455,48052,10979882.0,47596,51983.75
4338,257,256,10,10,267,266,267,266,570,534,532,71289,19034163.0,70756,71022.0
4339,47,38,11,27,100,99,195,194,120,295,293,19500,2876250.0,19206,21608.75
434,55,46,16,30,125,124,153,152,159,278,276,19125,2658375.0,18848,19182.0
4340,25,19,7,17,181,180,151,150,227,332,330,27331,4536946.0,27000,27390.0
4341,51,41,14,32,451,450,114,113,457,565,563,51414,14524455.0,50850,79523.75
4342,52,50,14,16,167,166,157,156,179,324,322,26219,4247478.0,25896,26082.0
4343,54,50,13,19,103,102,179,178,97,282,280,18437,2599617.0,18156,19740.0
4344,71,64,19,29,212,211,119,118,129,331,329,25228,4175234.0,24898,27224.75
4345,76,52,26,71,155,154,173,172,230,328,326,26815,4397660.0,26488,26732.0
4346,75,68,29,41,299,298,191,190,433,490,488,57109,13991705.0,56620,59780.0
4347,56,47,13,29,252,251,164,163,270,416,414,41328,8596224.0,40913,43056.0
4348,65,55,18,36,159,158,121,120,131,280,278,19239,2693460.0,18960,19460.0
4349,47,41,19,29,430,429,188,187,848,618,616,80840,24979560.0,80223,95172.0
435,49,42,16,28,216,215,112,111,133,328,326,24192,3967488.0,23865,26732.0
4350,78,69,24,40,154,153,267,266,362,421,419,41118,8655339.0,40698,44099.75
4351,36,35,10,10,122,121,94,93,53,216,214,11468,1238544.0,11253,11556.0
4352,45,38,16,28,166,165,200,199,188,366,364,33200,6075600.0,32835,33306.0
4353,81,66,23,45,276,275,149,148,220,425,423,41124,8738850.0,40700,44943.75
4354,49,42,14,26,95,94,148,147,88,243,241,14060,1708290.0,13818,14640.75
4355,44,35,17,27,209,208,134,133,189,343,341,28006,4803029.0,27664,29240.75
4356,56,42,17,40,229,228,179,178,289,408,406,40991,8362164.0,40584,41412.0
4357,50,43,13,23,176,175,127,126,112,303,301,22352,3386328.0,22050,22800.75
4358,60,53,17,28,155,154,180,179,157,335,333,27900,4673250.0,27566,27888.75
4359,62,52,16,30,124,123,115,114,73,239,237,14260,1704070.0,14022,14160.75
436,38,34,9,15,84,83,157,156,89,241,239,13188,1589154.0,12948,14399.75
4360,31,28,9,12,135,134,128,127,105,263,261,17280,2272320.0,17018,17160.75
4361,68,60,17,31,177,176,134,133,134,311,309,23718,3688149.0,23408,24024.75
4362,391,383,13,27,405,404,405,404,3119,810,808,164025,66430125.0,163216,163620.0
4363,76,64,27,47,229,228,268,267,420,497,495,61372,15250942.0,60876,61503.75
4364,86,77,27,43,249,248,202,201,524,451,449,50298,11342199.0,49848,50624.75
4365,69,59,17,33,192,191,111,110,170,303,301,21312,3228768.0,21010,22800.75
4366,96,81,26,54,225,224,169,168,258,394,392,38025,7490925.0,37632,38612.0
4367,70,57,26,48,124,123,206,205,206,330,328,25544,4214760.0,25215,27060.0
437,39,35,12,17,102,101,138,137,75,240,238,14076,1689120.0,13837,14280.0
4370,61,54,17,29,153,152,251,250,212,404,402,38403,7757406.0,38000,40602.0
4371,79,69,25,42,216,215,243,242,486,459,457,52488,12045996.0,52030,52440.75
4372,22,20,5,7,173,172,101,100,112,274,272,17473,2393801.0,17200,18632.0
4373,48,41,15,27,252,251,111,110,166,363,361,27972,5076918.0,27610,32760.75
4374,116,106,34,52,236,235,309,308,717,545,543,72924,19871790.0,72380,73983.75
4375,84,68,29,58,302,301,202,201,396,504,502,61004,15373008.0,60501,63252.0
4376,30,25,12,18,140,139,133,132,96,273,271,18620,2541630.0,18348,18495.75
4377,49,36,15,33,184,183,215,214,266,399,397,39560,7892220.0,39162,39600.75
4378,29,17,9,29,109,108,137,136,85,246,244,14933,1836759.0,14688,15006.0
4379,86,80,16,26,145,144,167,166,118,312,310,24215,3777540.0,23904,24180.0
438,30,25,7,14,142,141,101,100,72,243,241,14342,1742553.0,14100,14640.75
4380,31,23,13,26,149,148,115,114,131,264,262,17135,2261820.0,16872,17292.0
4381,58,45,19,39,154,153,164,163,168,318,316,25256,4015704.0,24939,25122.0
4382,142,119,41,85,270,269,230,229,598,500,498,62100,15525000.0,61601,62250.0
4383,72,62,24,41,157,156,176,175,151,333,331,27632,4600728.0,27300,27555.75
4384,128,100,40,93,351,350,274,273,870,625,623,96174,30054375.0,95550,97343.75
4385,24,23,5,5,90,89,92,91,36,182,180,8280,753480.0,8099,8190.0
4386,25,19,7,17,275,274,312,311,768,587,585,85800,25182300.0,85214,85848.75
4387,21,16,6,12,87,86,269,268,152,356,354,23403,4165734.0,23048,31506.0
4388,38,32,12,19,104,103,96,95,54,200,198,9984,998400.0,9785,9900.0
4389,84,74,23,41,356,355,198,197,594,554,552,70488,19525176.0,69935,76452.0
439,55,40,16,42,206,205,182,181,251,388,386,37492,7273448.0,37105,37442.0
4390,90,76,24,49,216,215,150,149,216,366,364,32400,5929200.0,32035,33306.0
4391,103,82,29,69,221,220,267,266,557,488,486,59007,14397708.0,58520,59292.0
4393,23,19,4,8,87,86,178,177,78,265,263,15486,2051895.0,15222,17423.75
4394,78,74,19,25,124,123,142,141,84,266,264,17608,2341864.0,17343,17556.0
4395,47,38,12,28,173,172,101,100,101,274,272,17473,2393801.0,17200,18632.0
4396,56,33,10,54,213,212,166,165,304,379,377,35358,6700341.0,34980,35720.75
4397,66,61,15,23,102,101,313,312,255,415,413,31926,6624645.0,31512,42848.75
4398,48,38,11,25,148,147,111,110,103,259,257,16428,2127426.0,16170,16640.75
4399,66,58,14,27,163,162,167,166,209,330,328,27221,4491465.0,26892,27060.0
44,42,37,10,18,140,139,136,135,105,276,274,19040,2627520.0,18765,18906.0
440,49,40,18,33,159,158,245,244,297,404,402,38955,7868910.0,38552,40602.0
4400,41,35,11,20,119,118,97,96,54,216,214,11543,1246644.0,11328,11556.0
4401,38,36,10,12,248,247,98,97,177,346,344,24304,4204592.0,23959,29756.0
4402,43,37,9,17,100,99,95,94,51,195,193,9500,926250.0,9306,9408.75
4403,66,61,16,23,107,106,160,159,84,267,265,17120,2285520.0,16854,17688.75
4404,74,57,27,59,144,143,230,229,257,374,372,33120,6193440.0,32747,34782.0
4405,21,20,2,2,76,75,154,153,60,230,228,11704,1345960.0,11475,13110.0
4406,49,42,12,23,195,194,141,140,166,336,334,27495,4619160.0,27160,28056.0
4408,158,126,53,115,401,400,417,416,2560,818,816,167217,68391753.0,166400,166872.0
4409,39,35,15,20,269,268,255,254,503,524,522,68595,17971890.0,68072,68382.0
441,142,136,13,23,189,188,223,222,370,412,410,42147,8682282.0,41736,42230.0
4410,48,45,12,15,115,114,135,134,90,250,248,15525,1940625.0,15276,15500.0
4411,54,45,15,31,149,148,163,162,128,312,310,24287,3788772.0,23976,24180.0
4412,36,21,8,23,126,125,100,99,87,226,224,12600,1423800.0,12375,12656.0
4413,41,35,17,25,148,147,127,126,92,275,273,18796,2584450.0,18522,18768.75
4414,59,54,18,26,187,186,178,177,208,365,363,33286,6074695.0,32922,33123.75
4415,41,38,13,17,83,82,267,266,202,350,348,22161,3878175.0,21812,30450.0
4416,39,33,14,24,158,157,92,91,95,250,248,14536,1817000.0,14287,15500.0
4417,45,39,10,18,95,94,98,97,53,193,191,9310,898415.0,9118,9215.75
4418,26,23,6,9,182,181,137,136,175,319,317,24934,3976973.0,24616,25280.75
4419,42,35,14,23,115,114,114,113,68,229,227,13110,1501095.0,12882,12995.75
442,61,54,15,24,131,130,128,127,86,259,257,16768,2171456.0,16510,16640.75
4420,152,124,44,96,386,385,287,286,1455,673,671,110782,37278143.0,110110,112895.75
4421,93,81,21,43,146,145,235,234,308,381,379,34310,6536055.0,33930,36099.75
4422,142,126,38,68,282,281,492,491,1789,774,772,138744,53693928.0,137971,149382.0
4423,36,30,11,21,177,176,220,219,537,397,395,38940,7729590.0,38544,39203.75
4424,118,117,7,7,124,123,216,215,152,340,338,26784,4553280.0,26445,28730.0
4425,40,35,13,18,125,124,99,98,62,224,222,12375,1386000.0,12152,12432.0
4426,80,60,20,55,237,236,233,232,512,470,468,55221,12976935.0,54752,54990.0
4427,131,109,38,80,343,342,248,247,934,591,589,85064,25136412.0,84474,87024.75
4428,32,29,8,12,69,68,117,116,45,186,184,8073,750789.0,7888,8556.0
4429,103,93,21,38,203,202,161,160,157,364,362,32683,5948306.0,32320,32942.0
443,25,22,12,16,162,161,79,78,59,241,239,12798,1542159.0,12558,14399.75
4430,90,66,33,78,526,525,343,342,4755,869,867,180418,78391621.0,179550,188355.75
4431,70,59,21,41,170,169,174,173,172,344,342,29580,5087760.0,29237,29412.0
4432,69,63,14,24,126,125,124,123,73,250,248,15624,1953000.0,15375,15500.0
4433,87,80,21,33,145,144,175,174,165,320,318,25375,4060000.0,25056,25440.0
4434,58,54,20,23,167,166,127,126,171,294,292,21209,3117723.0,20916,21462.0
4435,91,82,23,39,177,176,311,310,468,488,486,55047,13431468.0,54560,59292.0
4436,19,18,5,5,99,98,75,74,25,174,172,7425,645975.0,7252,7482.0
4437,116,101,43,71,260,259,235,234,751,495,493,61100,15122250.0,60606,61008.75
4438,56,48,19,31,217,216,331,330,678,548,546,71827,19680598.0,71280,74802.0
4439,47,42,14,22,130,129,164,163,143,294,292,21320,3134040.0,21027,21462.0
444,173,150,51,94,312,311,448,447,1483,760,758,139776,53114880.0,139017,144020.0
4440,25,19,9,19,148,147,168,167,163,316,314,24864,3928512.0,24549,24806.0
4441,73,66,14,26,119,118,169,168,115,288,286,20111,2895984.0,19824,20592.0
4442,148,130,41,73,313,312,434,433,1849,747,745,135842,50736987.0,135096,139128.75
4444,47,33,11,36,152,151,112,111,107,264,262,17024,2247168.0,16761,17292.0
4445,58,48,23,41,252,251,282,281,603,534,532,71064,18974088.0,70531,71022.0
4446,37,28,8,16,146,145,122,121,109,268,266,17812,2386808.0,17545,17822.0
4447,425,417,16,30,506,505,447,446,7318,953,951,226182,107775723.0,225230,226575.75
4448,87,72,25,50,185,184,390,389,738,575,573,72150,20743125.0,71576,82368.75
4449,52,41,16,35,166,165,109,108,110,275,273,18094,2487925.0,17820,18768.75
445,78,67,23,42,212,211,179,178,391,391,389,37948,7418834.0,37558,38024.75
4450,61,53,11,23,104,103,116,115,44,220,218,12064,1327040.0,11845,11990.0
4451,53,47,13,21,128,127,139,138,91,267,265,17792,2375232.0,17526,17688.75
4452,53,45,18,32,139,138,178,177,153,317,315,24742,3921607.0,24426,24963.75
4453,25,24,5,5,158,157,88,87,73,246,244,13904,1710192.0,13659,15006.0
4454,64,50,21,45,162,161,191,190,172,353,351,30942,5461263.0,30590,30975.75
4455,68,52,18,43,169,168,120,119,134,289,287,20280,2930460.0,19992,20735.75
4456,39,36,11,15,356,355,243,242,592,599,597,86508,25909146.0,85910,89400.75
4457,30,25,6,14,328,327,155,154,504,483,481,50840,12277860.0,50358,58080.75
4458,100,83,36,68,238,237,340,339,798,578,576,80920,23385880.0,80343,83232.0
4459,39,32,12,21,133,132,223,222,259,356,354,29659,5279302.0,29304,31506.0
446,66,49,26,57,238,237,177,176,288,415,413,42126,8741145.0,41712,42848.75
4460,111,93,25,55,221,220,154,153,234,375,373,34034,6381375.0,33660,34968.75
4461,58,44,17,43,128,127,180,179,169,308,306,23040,3548160.0,22733,23562.0
4462,69,53,16,45,128,127,133,132,100,261,259,17024,2221632.0,16764,16899.75
4463,61,53,17,29,142,141,207,206,191,349,347,29394,5129253.0,29046,30275.75
4464,59,48,21,39,200,199,119,118,193,319,317,23800,3796100.0,23482,25280.75
4465,61,50,18,38,122,121,154,153,98,276,274,18788,2592744.0,18513,18906.0
4466,43,33,10,28,192,191,148,147,146,340,338,28416,4830720.0,28077,28730.0
4467,43,40,10,14,168,167,90,89,84,258,256,15120,1950480.0,14863,16512.0
4468,391,383,13,27,405,404,405,404,3081,810,808,164025,66430125.0,163216,163620.0
4469,89,73,27,57,210,209,222,221,355,432,430,46620,10069920.0,46189,46440.0
447,83,72,22,40,178,177,281,280,406,459,457,50018,11479131.0,49560,52440.75
4470,45,25,12,50,146,145,199,198,201,345,343,29054,5011815.0,28710,29583.75
4471,72,62,18,36,153,152,111,110,86,264,262,16983,2241756.0,16720,17292.0
4472,18,17,4,4,94,93,111,110,51,205,203,10434,1069485.0,10230,10403.75
4473,46,44,15,17,226,225,250,249,611,476,474,56500,13447000.0,56025,56406.0
4474,66,62,19,25,103,102,158,157,79,261,259,16274,2123757.0,16014,16899.75
4475,66,55,22,41,260,259,169,168,296,429,427,43940,9425130.0,43512,45795.75
4477,44,36,12,26,180,179,102,101,152,282,280,18360,2588760.0,18079,19740.0
4478,33,29,13,18,218,217,231,230,399,449,447,50358,11305371.0,49910,50175.75
4479,39,31,14,23,95,94,196,195,114,291,289,18620,2709210.0,18330,21024.75
448,56,53,12,16,169,168,138,137,114,307,305,23322,3579927.0,23016,23408.75
4480,71,59,17,39,181,180,110,109,80,291,289,19910,2896905.0,19620,21024.75
4481,73,61,24,46,191,190,152,151,171,343,341,29032,4978988.0,28690,29240.75
4482,68,55,25,49,220,219,242,241,377,462,460,53240,12298440.0,52779,53130.0
4483,55,47,12,24,100,99,119,118,55,219,217,11900,1303050.0,11682,11880.75
4484,35,31,11,15,141,140,223,222,232,364,362,31443,5722626.0,31080,32942.0
4485,70,59,20,40,228,227,249,248,489,477,475,56772,13540122.0,56296,56643.75
4486,44,36,10,24,154,153,89,88,68,243,241,13706,1665279.0,13464,14640.75
4487,24,22,8,9,85,84,155,154,61,240,238,13175,1581000.0,12936,14280.0
4488,51,42,16,32,125,124,100,99,57,225,223,12500,1406250.0,12276,12543.75
4489,55,48,15,26,91,90,191,190,137,282,280,17381,2450721.0,17100,19740.0
449,65,61,14,20,94,93,142,141,70,236,234,13348,1575064.0,13113,13806.0
4490,25,17,6,14,114,113,116,115,73,230,228,13224,1520760.0,12995,13110.0
4491,77,67,22,38,200,199,193,192,429,393,391,38600,7584900.0,38208,38415.75
4492,44,38,12,21,177,176,126,125,117,303,301,22302,3378753.0,22000,22800.75
4493,45,39,10,18,126,125,120,119,116,246,244,15120,1859760.0,14875,15006.0
4494,59,58,16,16,87,86,190,189,142,277,275,16530,2289405.0,16254,19043.75
4495,35,29,16,26,115,114,241,240,222,356,354,27715,4933270.0,27360,31506.0
4496,43,38,17,22,182,181,175,174,233,357,355,31850,5685225.0,31494,31683.75
4497,54,44,18,36,188,187,95,94,109,283,281,17860,2527190.0,17578,19880.75
4498,71,62,21,35,213,212,152,151,174,365,363,32376,5908620.0,32012,33123.75
4499,83,68,25,53,223,222,164,163,247,387,385,36572,7076682.0,36186,37248.75
45,66,59,18,28,182,181,139,138,122,321,319,25298,4060329.0,24978,25599.75
450,77,55,17,51,137,136,176,175,150,313,311,24112,3773528.0,23800,24335.75
4500,40,34,12,21,214,213,123,122,154,337,335,26322,4435257.0,25986,28223.75
4501,70,56,19,45,263,262,146,145,230,409,407,38398,7852391.0,37990,41615.75
4502,62,51,22,42,186,185,189,188,224,375,373,35154,6591375.0,34780,34968.75
4503,65,61,17,23,171,170,140,139,157,311,309,23940,3722670.0,23630,24024.75
4504,46,36,15,33,287,286,293,292,1013,580,578,84091,24386390.0,83512,83810.0
4505,44,41,10,14,103,102,146,145,69,249,247,15038,1872231.0,14790,15375.75
4506,41,36,16,24,81,80,213,212,107,294,292,17253,2536191.0,16960,21462.0
4507,39,33,14,24,159,158,189,188,175,348,346,30051,5228874.0,29704,30102.0
4508,40,28,12,33,120,119,195,194,198,315,313,23400,3685500.0,23086,24648.75
4509,58,48,12,30,127,126,182,181,115,309,307,23114,3571113.0,22806,23715.75
451,66,56,20,33,155,154,200,199,210,355,353,31000,5502500.0,30646,31328.75
4510,46,36,15,31,172,171,113,112,108,285,283,19436,2769630.0,19152,20163.75
4511,82,74,15,29,123,122,147,146,114,270,268,18081,2440935.0,17812,18090.0
4513,90,78,29,51,183,182,177,176,217,360,358,32391,5830380.0,32032,32220.0
4514,27,22,7,13,89,88,162,161,84,251,249,14418,1809459.0,14168,15624.75
4515,257,256,10,10,267,266,267,266,602,534,532,71289,19034163.0,70756,71022.0
4516,52,46,17,24,151,150,114,113,91,265,263,17214,2280855.0,16950,17423.75
4517,106,89,40,72,249,248,298,297,830,547,545,74202,20294247.0,73656,74528.75
4518,52,44,13,24,116,115,130,129,95,246,244,15080,1854840.0,14835,15006.0
4519,32,25,10,17,132,131,280,279,221,412,410,36960,7613760.0,36549,42230.0
452,80,70,22,40,163,162,225,224,191,388,386,36675,7114950.0,36288,37442.0
4520,75,59,23,53,129,128,202,201,185,331,329,26058,4312599.0,25728,27224.75
4521,29,28,6,6,114,113,107,106,59,221,219,12198,1347879.0,11978,12099.75
4523,58,52,17,27,118,117,104,103,61,222,220,12272,1362192.0,12051,12210.0
4524,18,17,6,6,198,197,244,243,317,442,440,48312,10676952.0,47871,48620.0
4525,21,19,5,7,92,91,116,115,43,208,206,10672,1109888.0,10465,10712.0
4526,71,59,18,39,187,186,171,170,186,358,356,31977,5723883.0,31620,31862.0
4527,58,45,21,42,237,236,205,204,375,442,440,48585,10737285.0,48144,48620.0
4528,66,55,18,37,165,164,179,178,152,344,342,29535,5080020.0,29192,29412.0
4529,76,64,23,44,267,266,199,198,446,466,464,53133,12379989.0,52668,54056.0
453,135,110,38,86,325,324,236,235,747,561,559,76700,21514350.0,76140,78399.75
4530,72,64,15,27,143,142,157,156,128,300,298,22451,3367650.0,22152,22350.0
4531,79,68,18,38,227,226,151,150,247,378,376,34277,6478353.0,33900,35532.0
4532,27,23,9,13,128,127,183,182,166,311,309,23424,3642432.0,23114,24024.75
4533,32,27,12,19,136,135,123,122,84,259,257,16728,2166276.0,16470,16640.75
4534,56,49,17,29,153,152,187,186,163,340,338,28611,4863870.0,28272,28730.0
4535,54,45,20,35,209,208,186,185,419,395,393,38874,7677615.0,38480,38808.75
4536,17,16,5,5,181,180,116,115,103,297,295,20996,3117906.0,20700,21903.75
4537,61,57,24,29,324,323,264,263,829,588,586,85536,25147584.0,84949,86142.0
4538,53,41,16,38,209,208,123,122,178,332,330,25707,4267362.0,25376,27390.0
4539,52,43,18,34,145,144,185,184,231,330,328,26825,4426125.0,26496,27060.0
454,90,81,29,45,198,197,180,179,293,378,376,35640,6735960.0,35263,35532.0
4540,63,52,21,39,456,455,310,309,1583,766,764,141360,54140880.0,140595,146306.0
4541,50,45,14,22,148,147,110,109,86,258,256,16280,2100120.0,16023,16512.0
4542,43,39,10,13,100,99,112,111,59,212,210,11200,1187200.0,10989,11130.0
4543,48,37,12,28,111,110,87,86,48,198,196,9657,956043.0,9460,9702.0
4544,57,42,16,38,107,106,154,153,96,261,259,16478,2150379.0,16218,16899.75
4546,53,49,15,21,191,190,177,176,228,368,366,33807,6220488.0,33440,33672.0
4547,53,37,15,43,183,182,111,110,135,294,292,20313,2986011.0,20020,21462.0
4548,129,116,22,45,215,214,274,273,570,489,487,58910,14403495.0,58422,59535.75
455,94,74,32,68,261,260,264,263,797,525,523,68904,18087300.0,68380,68643.75
4550,62,57,16,24,131,130,93,92,50,224,222,12183,1364496.0,11960,12432.0
4551,54,46,11,20,141,140,88,87,72,229,227,12408,1420716.0,12180,12995.75
4552,95,79,33,63,376,375,334,333,1215,710,708,125584,44582320.0,124875,125670.0
4553,71,57,22,46,135,134,161,160,133,296,294,21735,3216780.0,21440,21756.0
4554,41,33,16,30,165,164,110,109,88,275,273,18150,2495625.0,17876,18768.75
4555,99,83,34,64,250,249,180,179,252,430,428,45000,9675000.0,44571,46010.0
4556,80,63,23,54,194,193,162,161,195,356,354,31428,5594184.0,31073,31506.0
4557,59,54,10,18,98,97,113,112,53,211,209,11074,1168307.0,10864,11024.75
4558,74,66,17,31,156,155,151,150,151,307,305,23556,3615846.0,23250,23408.75
4559,55,45,23,40,197,196,196,195,333,393,391,38612,7587258.0,38220,38415.75
456,231,230,20,20,303,302,250,249,631,553,551,75750,20944875.0,75198,76175.75
4560,103,85,27,59,247,246,210,209,388,457,455,51870,11852295.0,51414,51983.75
4562,51,44,16,28,98,97,162,161,77,260,258,15876,2063880.0,15617,16770.0
4563,65,53,22,41,347,346,212,211,629,559,557,73564,20561138.0,73006,77840.75
4564,43,38,12,20,111,110,137,136,73,248,246,15207,1885668.0,14960,15252.0
4565,38,33,13,21,125,124,150,149,146,275,273,18750,2578125.0,18476,18768.75
4566,114,98,20,47,152,151,211,210,285,363,361,32072,5821068.0,31710,32760.75
4567,140,125,34,61,354,353,238,237,836,592,590,84252,24938592.0,83661,87320.0
4568,45,37,15,25,322,321,245,244,782,567,565,78890,22365315.0,78324,80088.75
4569,32,26,7,14,87,86,114,113,53,201,199,9918,996759.0,9718,9999.75
457,35,28,11,23,206,205,97,96,130,303,301,19982,3027273.0,19680,22800.75
4570,116,99,43,74,322,321,364,363,1315,686,684,117208,40202344.0,116523,117306.0
4571,44,37,16,27,156,155,97,96,71,253,251,15132,1914198.0,14880,15875.75
4572,47,38,12,26,171,170,100,99,105,271,269,17100,2317050.0,16830,18224.75
4573,36,33,14,18,128,127,152,151,152,280,278,19456,2723840.0,19177,19460.0
4574,37,33,13,19,113,112,129,128,56,242,240,14577,1763817.0,14336,14520.0
4575,77,64,20,38,190,189,174,173,235,364,362,33060,6016920.0,32697,32942.0
4577,62,48,20,46,259,258,372,371,1064,631,629,96348,30397794.0,95718,99224.75
4578,51,42,17,33,189,188,212,211,306,401,399,40068,8033634.0,39668,39999.75
4579,105,96,23,36,165,164,193,192,198,358,356,31845,5700255.0,31488,31862.0
458,89,73,34,64,249,248,198,197,446,447,445,49302,11018997.0,48856,49728.75
4580,64,58,21,31,175,174,207,206,214,382,380,36225,6918975.0,35844,36290.0
4581,69,56,20,38,217,216,179,178,308,396,394,38843,7690914.0,38448,39006.0
4582,130,86,50,133,305,304,380,379,1277,685,683,115900,39695750.0,115216,116963.75
4583,82,60,28,70,227,226,194,193,475,421,419,44038,9269999.0,43618,44099.75
4584,75,58,22,53,164,163,152,151,160,316,314,24928,3938624.0,24613,24806.0
4586,144,132,35,55,356,355,434,433,2863,790,788,154504,61029080.0,153715,155630.0
4587,88,75,24,48,164,163,258,257,279,422,420,42312,8927832.0,41891,44310.0
4588,52,37,13,41,139,138,150,149,194,289,287,20850,3012825.0,20562,20735.75
4589,60,56,16,21,172,171,181,180,232,353,351,31132,5494798.0,30780,30975.75
459,45,41,13,19,145,144,165,164,127,310,308,23925,3708375.0,23616,23870.0
4590,64,55,26,42,229,228,143,142,246,372,370,32747,6090942.0,32376,34410.0
4591,129,106,43,87,387,386,315,314,1122,702,700,121905,42788655.0,121204,122850.0
4592,41,32,14,28,139,138,132,131,101,271,269,18348,2486154.0,18078,18224.75
4593,70,52,26,60,262,261,217,216,570,479,477,56854,13616533.0,56376,57120.75
4594,55,44,20,38,170,169,225,224,280,395,393,38250,7554375.0,37856,38808.75
4596,62,55,21,31,194,193,134,133,167,328,326,25996,4263344.0,25669,26732.0
4597,59,56,17,21,280,279,133,132,315,413,411,37240,7690060.0,36828,42435.75
4598,48,41,15,23,106,105,181,180,108,287,285,19186,2753191.0,18900,20448.75
4599,34,32,11,13,102,101,132,131,74,234,232,13464,1575288.0,13231,13572.0
46,71,57,25,51,424,423,373,372,1739,797,795,158152,63023572.0,157356,158403.75
460,52,41,16,36,141,140,173,172,123,314,312,24393,3829701.0,24080,24492.0
4600,87,78,20,36,164,163,143,142,115,307,305,23452,3599882.0,23146,23408.75
4601,99,84,27,54,329,328,267,266,819,596,594,87843,26177214.0,87248,88506.0
4602,59,47,16,37,153,152,110,109,93,263,261,16830,2213145.0,16568,17160.75
4603,28,19,10,25,171,170,172,171,194,343,341,29412,5044158.0,29070,29240.75
4604,46,31,12,38,94,93,82,81,40,176,174,7708,678304.0,7533,7656.0
4605,77,67,23,41,142,141,151,150,132,293,291,21442,3141253.0,21150,21315.75
4607,88,71,28,60,233,232,181,180,305,414,412,42173,8729811.0,41760,42642.0
4608,38,34,10,14,104,103,97,96,44,201,199,10088,1013844.0,9888,9999.75
4609,86,74,28,48,227,226,204,203,258,431,429,46308,9979374.0,45878,46224.75
461,17,15,5,6,149,148,81,80,56,230,228,12069,1387935.0,11840,13110.0
4611,56,47,17,31,134,133,228,227,228,362,360,30552,5529912.0,30191,32580.0
4612,47,40,15,23,373,372,405,404,2595,778,776,151065,58764285.0,150288,150932.0
4613,57,49,18,31,129,128,134,133,104,263,261,17286,2273109.0,17024,17160.75
4614,49,35,9,35,163,162,123,122,131,286,284,20049,2867007.0,19764,20306.0
4615,42,37,11,17,133,132,79,78,47,212,210,10507,1113742.0,10296,11130.0
4616,53,45,19,31,157,156,193,192,168,350,348,30301,5302675.0,29952,30450.0
4617,69,48,24,60,200,199,189,188,233,389,387,37800,7352100.0,37412,37635.75
4618,50,40,17,33,157,156,168,167,188,325,323,26376,4286100.0,26052,26243.75
4619,49,44,16,22,137,136,96,95,80,233,231,13152,1532208.0,12920,13455.75
462,58,49,14,29,98,97,151,150,75,249,247,14798,1842351.0,14550,15375.75
4621,60,55,15,23,166,165,107,106,85,273,271,17762,2424513.0,17490,18495.75
4622,89,76,27,48,189,188,187,186,219,376,374,35343,6644484.0,34968,35156.0
4623,64,56,19,32,144,143,250,249,289,394,392,36000,7092000.0,35607,38612.0
4624,57,48,11,24,113,112,126,125,58,239,237,14238,1701441.0,14000,14160.75
4625,79,71,18,30,150,149,259,258,440,409,407,38850,7944825.0,38442,41615.75
4626,66,59,15,27,188,187,112,111,162,300,298,21056,3158400.0,20757,22350.0
4627,63,53,14,29,163,162,103,102,94,266,264,16789,2232937.0,16524,17556.0
4628,33,29,12,16,197,196,134,133,163,331,329,26398,4368869.0,26068,27224.75
4629,90,85,21,29,245,244,136,135,196,381,379,33320,6347460.0,32940,36099.75
463,58,52,23,33,309,308,372,371,949,681,679,114948,39139794.0,114268,115599.75
4631,184,153,46,104,499,498,367,366,1770,866,864,183133,79296589.0,182268,187056.0
4632,69,53,20,50,225,224,158,157,240,383,381,35550,6807825.0,35168,36480.75
4633,29,24,12,20,117,116,100,99,58,217,215,11700,1269450.0,11484,11663.75
4635,148,125,36,80,225,224,225,224,376,450,448,50625,11390625.0,50176,50400.0
4636,61,57,19,25,174,173,166,165,171,340,338,28884,4910280.0,28545,28730.0
4637,19,18,5,5,121,120,138,137,83,259,257,16698,2162391.0,16440,16640.75
4638,37,32,15,21,145,144,128,127,151,273,271,18560,2533440.0,18288,18495.75
4639,26,24,11,12,222,221,198,197,283,420,418,43956,9230760.0,43537,43890.0
464,35,33,10,11,114,113,158,157,93,272,270,18012,2449632.0,17741,18360.0
4640,90,74,31,60,421,420,229,228,996,650,648,96409,31332925.0,95760,105300.0
4641,77,63,16,41,180,179,148,147,131,328,326,26640,4368960.0,26313,26732.0
4642,113,102,23,43,168,167,201,200,218,369,367,33768,6230196.0,33400,33855.75
4643,49,41,19,31,96,95,149,148,105,245,243,14304,1752240.0,14060,14883.75
4644,63,53,18,34,132,131,171,170,130,303,301,22572,3419658.0,22270,22800.75
4645,58,49,18,34,186,185,248,247,410,434,432,46128,10009776.0,45695,46872.0
4646,87,71,21,51,183,182,141,140,168,324,322,25803,4180086.0,25480,26082.0
4647,40,33,15,27,153,152,145,144,133,298,296,22185,3305565.0,21888,22052.0
4648,70,53,23,55,182,181,187,186,235,369,367,34034,6279273.0,33666,33855.75
4649,43,36,13,23,117,116,167,166,118,284,282,19539,2774538.0,19256,20022.0
465,140,139,8,8,262,261,147,146,243,409,407,38514,7876113.0,38106,41615.75
4650,146,131,22,50,241,240,203,202,509,444,442,48923,10860906.0,48480,49062.0
4651,108,92,29,58,348,347,267,266,980,615,613,92916,28571670.0,92302,94248.75
4652,30,27,9,12,97,96,183,182,94,280,278,17751,2485140.0,17472,19460.0
4653,26,24,8,10,212,211,104,103,154,316,314,22048,3483584.0,21733,24806.0
4655,131,107,41,87,336,335,494,493,2356,830,828,165984,68883360.0,165155,171810.0
4656,200,169,61,119,320,319,483,482,2069,803,801,154560,62055840.0,153758,160800.75
4657,58,47,15,33,207,206,261,260,568,468,466,54027,12642318.0,53560,54522.0
4658,23,16,7,19,285,284,487,486,1614,772,770,138795,53574870.0,138024,148610.0
4659,68,53,15,43,125,124,160,159,208,285,283,20000,2850000.0,19716,20163.75
466,40,26,12,38,145,144,225,224,275,370,368,32625,6035625.0,32256,34040.0
4660,64,51,15,37,98,97,179,178,124,277,275,17542,2429567.0,17266,19043.75
4661,99,80,33,68,368,367,245,244,808,613,611,90160,27634040.0,89548,93635.75
4662,63,54,17,33,277,276,266,265,596,543,541,73682,20004663.0,73140,73440.75
4663,37,34,10,13,116,115,124,123,86,240,238,14384,1726080.0,14145,14280.0
4664,99,76,26,70,269,268,244,243,504,513,511,65636,16835634.0,65124,65535.75
4665,50,44,19,29,349,348,189,188,732,538,536,65961,17743509.0,65424,72092.0
4666,39,31,9,21,135,134,90,89,79,225,223,12150,1366875.0,11926,12543.75
4667,52,39,17,38,205,204,217,216,324,422,420,44485,9386335.0,44064,44310.0
4668,55,49,18,27,166,165,122,121,119,288,286,20252,2916288.0,19965,20592.0
4669,63,52,18,37,152,151,280,279,307,432,430,42560,9192960.0,42129,46440.0
467,39,35,13,19,128,127,175,174,101,303,301,22400,3393600.0,22098,22800.75
4671,33,30,11,14,108,107,149,148,85,257,255,16092,2067822.0,15836,16383.75
4672,82,71,25,45,143,142,196,195,172,339,337,28028,4750746.0,27690,28560.75
4673,92,69,20,64,173,172,267,266,327,440,438,46191,10162020.0,45752,48180.0
4674,38,35,11,15,235,234,195,194,373,430,428,45825,9852375.0,45396,46010.0
4675,178,177,0,0,178,177,178,177,202,356,354,31684,5639752.0,31329,31506.0
4676,32,27,13,21,139,138,179,178,118,318,316,24881,3956079.0,24564,25122.0
4677,43,36,12,23,130,129,105,104,101,235,233,13650,1603875.0,13416,13688.75
4678,42,37,14,22,136,135,112,111,115,248,246,15232,1888768.0,14985,15252.0
4679,95,86,19,34,298,297,261,260,599,559,557,77778,21738951.0,77220,77840.75
468,39,33,12,22,214,213,105,104,133,319,317,22470,3583965.0,22152,25280.75
4680,55,43,13,34,267,266,244,243,639,511,509,65148,16645314.0,64638,65024.75
4681,26,17,9,24,101,100,169,168,123,270,268,17069,2304315.0,16800,18090.0
4682,48,41,12,24,258,257,165,164,252,423,421,42570,9003555.0,42148,44520.75
4683,65,49,13,42,127,126,98,97,54,225,223,12446,1400175.0,12222,12543.75
4684,24,23,5,5,174,173,168,167,214,342,340,29232,4998672.0,28891,29070.0
4685,257,256,10,10,267,266,267,266,613,534,532,71289,19034163.0,70756,71022.0
4686,44,34,12,29,125,124,88,87,67,213,211,11000,1171500.0,10788,11235.75
4687,46,37,16,29,127,126,87,86,54,214,212,11049,1182243.0,10836,11342.0
4688,69,60,20,34,209,208,201,200,458,410,408,42009,8611845.0,41600,41820.0
4689,354,340,19,45,405,404,377,376,2232,782,780,152685,59699835.0,151904,152490.0
469,55,47,17,31,235,234,178,177,252,413,411,41830,8637895.0,41418,42435.75
4690,54,39,16,44,264,263,249,248,697,513,511,65736,16861284.0,65224,65535.75
4691,26,20,5,10,139,138,152,151,135,291,289,21128,3074124.0,20838,21024.75
4692,31,25,7,15,116,115,125,124,82,241,239,14500,1747250.0,14260,14399.75
4693,59,45,17,43,132,131,269,268,265,401,399,35508,7119354.0,35108,39999.75
4694,74,62,24,46,230,229,267,266,613,497,495,61410,15260385.0,60914,61503.75
4695,50,41,16,31,141,140,146,145,158,287,285,20586,2954091.0,20300,20448.75
4696,68,63,13,21,108,107,160,159,226,268,266,17280,2315520.0,17013,17822.0
4697,27,25,5,7,94,93,71,70,29,165,163,6674,550605.0,6510,6723.75
47,56,49,12,23,166,165,180,179,158,346,344,29880,5169240.0,29535,29756.0
470,44,34,12,30,106,105,108,107,64,214,212,11448,1224936.0,11235,11342.0
4700,61,45,18,46,118,117,205,204,184,323,321,24190,3906685.0,23868,25920.75
4701,50,41,10,23,157,156,96,95,71,253,251,15072,1906608.0,14820,15875.75
4702,55,41,17,42,94,93,164,163,96,258,256,15416,1988664.0,15159,16512.0
4703,55,43,12,33,218,217,127,126,234,345,343,27686,4775835.0,27342,29583.75
4704,133,112,49,88,465,464,249,248,861,714,712,115785,41335245.0,115072,127092.0
4705,196,195,12,12,492,491,239,238,2424,731,729,117588,42978414.0,116858,133224.75
4706,99,77,31,72,261,260,188,187,407,449,447,49068,11015766.0,48620,50175.75
4707,85,69,22,51,173,172,205,204,253,378,376,35465,6702885.0,35088,35532.0
4708,112,88,37,82,241,240,286,285,534,527,525,68926,18162001.0,68400,69168.75
4709,44,37,16,25,117,116,118,117,69,235,233,13806,1622205.0,13572,13688.75
471,36,32,14,20,117,116,146,145,110,263,261,17082,2246283.0,16820,17160.75
4710,68,59,19,34,175,174,117,116,125,292,290,20475,2989350.0,20184,21170.0
4711,62,46,22,52,467,466,295,294,1658,762,760,137765,52488465.0,137004,144780.0
4712,94,80,27,51,257,256,259,258,597,516,514,66563,17173254.0,66048,66306.0
4713,50,39,11,29,130,129,107,106,91,237,235,13910,1648335.0,13674,13923.75
4714,43,32,11,27,183,182,105,104,117,288,286,19215,2766960.0,18928,20592.0
4715,82,71,22,41,177,176,138,137,159,315,313,24426,3847095.0,24112,24648.75
4716,42,30,12,31,121,120,140,139,105,261,259,16940,2210670.0,16680,16899.75
4717,31,29,13,14,160,159,312,311,341,472,470,49920,11781120.0,49449,55460.0
4718,85,76,28,44,227,226,240,239,384,467,465,54480,12721080.0,54014,54288.75
4719,113,85,34,86,281,280,280,279,895,561,559,78680,22069740.0,78120,78399.75
472,79,71,31,45,259,258,226,225,500,485,483,58534,14194495.0,58050,58563.75
4721,63,54,22,37,146,145,284,283,269,430,428,41464,8914760.0,41035,46010.0
4722,50,47,15,19,128,127,163,162,101,291,289,20864,3035712.0,20574,21024.75
4723,175,147,66,119,374,373,510,509,4260,884,882,190740,84307080.0,189857,194922.0
4724,32,19,10,32,123,122,139,138,119,262,260,17097,2239707.0,16836,17030.0
4725,53,45,19,33,174,173,145,144,174,319,317,25230,4024185.0,24912,25280.75
4726,78,70,19,33,103,102,195,194,123,298,296,20085,2992665.0,19788,22052.0
4727,59,55,12,18,94,93,130,129,46,224,222,12220,1368640.0,11997,12432.0
4728,86,71,28,53,239,238,261,260,551,500,498,62379,15594750.0,61880,62250.0
4729,119,118,6,6,124,123,147,146,103,271,269,18228,2469894.0,17958,18224.75
473,70,59,24,44,177,176,211,210,235,388,386,37347,7245318.0,36960,37442.0
4730,36,28,12,26,163,162,98,97,87,261,259,15974,2084607.0,15714,16899.75
4731,46,41,16,24,103,102,180,179,107,283,281,18540,2623410.0,18258,19880.75
4732,61,52,18,32,142,141,179,178,178,321,319,25418,4079589.0,25098,25599.75
4733,71,63,26,40,244,243,238,237,345,482,480,58072,13995352.0,57591,57840.0
4734,35,28,8,15,84,83,113,112,81,197,195,9492,934962.0,9296,9603.75
4735,60,42,16,50,197,196,151,150,262,348,346,29747,5175978.0,29400,30102.0
4736,36,29,11,23,129,128,114,113,71,243,241,14706,1786779.0,14464,14640.75
4737,35,30,9,14,150,149,114,113,98,264,262,17100,2257200.0,16837,17292.0
4738,118,117,6,6,124,123,124,123,77,248,246,15376,1906624.0,15129,15252.0
4739,35,30,8,16,161,160,178,177,231,339,337,28658,4857531.0,28320,28560.75
474,94,72,28,70,221,220,178,177,259,399,397,39338,7847931.0,38940,39600.75
4740,71,63,22,34,127,126,151,150,135,278,276,19177,2665603.0,18900,19182.0
4741,50,43,14,26,177,176,113,112,121,290,288,20001,2900145.0,19712,20880.0
4742,59,46,22,46,175,174,258,257,353,433,431,45150,9774975.0,44718,46655.75
4743,91,84,20,30,145,144,219,218,347,364,362,31755,5779410.0,31392,32942.0
4744,42,37,14,21,141,140,103,102,97,244,242,14523,1771806.0,14280,14762.0
4745,56,44,13,28,116,115,171,170,129,287,285,19836,2846466.0,19550,20448.75
4746,57,48,13,25,112,111,126,125,105,238,236,14112,1679328.0,13875,14042.0
4747,21,19,7,9,120,119,117,116,74,237,235,14040,1663740.0,13804,13923.75
4748,81,68,18,42,146,145,248,247,338,394,392,36208,7132976.0,35815,38612.0
4749,94,80,26,52,298,297,305,304,1644,603,601,90890,27403335.0,90288,90600.75
475,57,48,20,36,228,227,183,182,269,411,409,41724,8574282.0,41314,42024.75
4750,73,57,25,50,140,139,203,202,201,343,341,28420,4874030.0,28078,29240.75
4751,102,93,29,45,183,182,174,173,168,357,355,31842,5683797.0,31486,31683.75
4752,95,79,37,65,415,414,313,312,1343,728,726,129895,47281780.0,129168,132132.0
4753,79,65,17,43,138,137,160,159,132,298,296,22080,3289920.0,21783,22052.0
4754,88,72,34,60,377,376,306,305,873,683,681,115362,39396123.0,114680,116280.75
4755,88,84,25,31,155,154,149,148,110,304,302,23095,3510440.0,22792,22952.0
4756,58,52,17,27,98,97,126,125,78,224,222,12348,1382976.0,12125,12432.0
4757,54,46,19,33,229,228,212,211,396,441,439,48548,10704834.0,48108,48399.75
4758,67,55,22,43,119,118,172,171,154,291,289,20468,2978094.0,20178,21024.75
4759,63,56,16,27,196,195,129,128,137,325,323,25284,4108650.0,24960,26243.75
476,69,57,18,39,188,187,151,150,147,339,337,28388,4811766.0,28050,28560.75
4760,48,39,14,29,191,190,223,222,380,414,412,42593,8816751.0,42180,42642.0
4761,40,33,11,22,159,158,106,105,79,265,263,16854,2233155.0,16590,17423.75
4762,72,56,24,50,255,254,241,240,521,496,494,61455,15240840.0,60960,61256.0
4763,84,68,29,59,202,201,191,190,290,393,391,38582,7581363.0,38190,38415.75
4764,33,27,11,20,95,94,94,93,55,189,187,8930,843885.0,8742,8835.75
4765,43,36,16,25,133,132,251,250,286,384,382,33383,6409536.0,33000,36672.0
4766,62,55,19,31,118,117,122,121,59,240,238,14396,1727520.0,14157,14280.0
4767,63,52,20,36,159,158,169,168,141,328,326,26871,4406844.0,26544,26732.0
4768,51,44,18,27,136,135,131,130,87,267,265,17816,2378436.0,17550,17688.75
4769,39,32,8,18,100,99,135,134,108,235,233,13500,1586250.0,13266,13688.75
477,70,58,18,40,173,172,192,191,218,365,363,33216,6061920.0,32852,33123.75
4770,56,43,13,36,142,141,155,154,123,297,295,22010,3268485.0,21714,21903.75
4771,41,34,10,17,85,84,90,89,43,175,173,7650,669375.0,7476,7568.75
4772,52,44,16,30,209,208,156,155,282,365,363,32604,5950230.0,32240,33123.75
4773,33,24,9,24,110,109,111,110,81,221,219,12210,1349205.0,11990,12099.75
4774,71,55,24,54,236,235,134,133,236,370,368,31624,5850440.0,31255,34040.0
4775,194,150,67,153,431,430,495,494,3343,926,924,213345,98778735.0,212420,213906.0
4777,57,54,16,20,139,138,189,188,253,328,326,26271,4308444.0,25944,26732.0
4778,36,32,10,14,149,148,191,190,213,340,338,28459,4838030.0,28120,28730.0
4779,69,59,18,36,190,189,135,134,155,325,323,25650,4168125.0,25326,26243.75
478,82,75,25,37,223,222,193,192,331,416,414,43039,8952112.0,42624,43056.0
4780,44,36,9,23,120,119,144,143,89,264,262,17280,2280960.0,17017,17292.0
4781,121,102,41,77,398,397,233,232,977,631,629,92734,29257577.0,92104,99224.75
4782,53,47,14,23,132,131,118,117,78,250,248,15576,1947000.0,15327,15500.0
4783,144,107,46,114,351,350,333,332,1386,684,682,116883,39973986.0,116200,116622.0
4784,40,35,9,17,141,140,179,178,150,320,318,25239,4038240.0,24920,25440.0
4785,34,27,13,25,172,171,164,163,174,336,334,28208,4738944.0,27873,28056.0
4786,83,70,31,53,238,237,460,459,1358,698,696,109480,38208520.0,108783,121452.0
4787,56,45,20,38,206,205,180,179,258,386,384,37080,7156440.0,36695,37056.0
4788,94,80,27,52,328,327,160,159,464,488,486,52480,12805120.0,51993,59292.0
4789,72,60,15,32,138,137,152,151,173,290,288,20976,3041520.0,20687,20880.0
479,64,55,19,33,143,142,191,190,193,334,332,27313,4561271.0,26980,27722.0
4790,65,54,18,34,113,112,154,153,85,267,265,17402,2323167.0,17136,17688.75
4791,68,63,15,21,239,238,154,153,302,393,391,36806,7232379.0,36414,38415.75
4792,18,17,6,6,175,174,148,147,153,323,321,25900,4182850.0,25578,25920.75
4793,37,27,11,28,261,260,192,191,413,453,451,50112,11350368.0,49660,51075.75
4794,38,34,13,19,112,111,117,116,59,229,227,13104,1500408.0,12876,12995.75
4795,110,88,27,69,316,315,302,301,857,618,616,95432,29488488.0,94815,95172.0
4797,172,136,60,130,489,488,440,439,2787,929,927,215160,99941820.0,214232,215295.75
4798,60,52,21,32,138,137,156,155,181,294,292,21528,3164616.0,21235,21462.0
4799,83,73,20,36,194,193,167,166,220,361,359,32398,5847839.0,32038,32399.75
48,52,41,14,34,84,83,178,177,94,262,260,14952,1958712.0,14691,17030.0
480,60,50,20,38,186,185,134,133,171,320,318,24924,3987840.0,24605,25440.0
4800,101,71,26,78,249,248,205,204,483,454,452,51045,11587215.0,50592,51302.0
4801,90,64,29,77,259,258,251,250,520,510,508,65009,16577295.0,64500,64770.0
4802,25,24,8,8,218,217,105,104,138,323,321,22890,3696735.0,22568,25920.75
4803,85,69,19,47,193,192,162,161,222,355,353,31266,5549715.0,30912,31328.75
4804,78,63,25,53,261,260,132,131,234,393,391,34452,6769818.0,34060,38415.75
4805,81,65,20,49,134,133,143,142,113,277,275,19162,2653937.0,18886,19043.75
4806,28,24,9,15,187,186,120,119,156,307,305,22440,3444540.0,22134,23408.75
4807,57,44,11,35,127,126,111,110,87,238,236,14097,1677543.0,13860,14042.0
4808,46,27,12,48,126,125,120,119,119,246,244,15120,1859760.0,14875,15006.0
4809,102,88,34,60,381,380,321,320,1672,702,700,122301,42927651.0,121600,122850.0
481,97,80,36,67,270,269,196,195,326,466,464,52920,12330360.0,52455,54056.0
4811,133,124,20,36,209,208,234,233,437,443,441,48906,10832679.0,48464,48840.75
4812,91,78,26,50,401,400,235,234,1109,636,634,94235,29966730.0,93600,100806.0
4813,83,75,23,37,170,169,256,255,234,426,424,43520,9269760.0,43095,45156.0
4814,31,23,10,22,122,121,149,148,100,271,269,18178,2463119.0,17908,18224.75
4815,31,26,12,20,125,124,141,140,79,266,264,17625,2344125.0,17360,17556.0
4816,27,22,6,11,129,128,126,125,75,255,253,16254,2072385.0,16000,16128.75
4817,38,33,15,23,172,171,174,173,184,346,344,29928,5177544.0,29583,29756.0
4818,58,37,19,58,135,134,170,169,161,305,303,22950,3499875.0,22646,23103.75
4819,71,55,23,53,162,161,164,163,134,326,324,26568,4330584.0,26243,26406.0
482,36,35,8,8,112,111,93,92,52,205,203,10416,1067640.0,10212,10403.75
4820,87,69,25,59,210,209,391,390,1266,601,599,82110,24674055.0,81510,89999.75
4821,73,58,20,47,173,172,118,117,159,291,289,20414,2970237.0,20124,21024.75
4822,117,103,30,56,390,389,377,376,1971,767,765,147030,56386005.0,146264,146688.75
4823,69,54,20,48,179,178,198,197,334,377,375,35442,6680817.0,35066,35343.75
4824,107,95,35,57,295,294,269,268,868,564,562,79355,22378110.0,78792,79242.0
4825,35,26,12,27,178,177,202,201,275,380,378,35956,6831640.0,35577,35910.0
4826,122,99,36,79,309,308,195,194,451,504,502,60255,15184260.0,59752,63252.0
4827,22,19,8,12,157,156,172,171,165,329,327,27004,4442158.0,26676,26895.75
4828,68,40,21,75,135,134,234,233,254,369,367,31590,5828355.0,31222,33855.75
4829,62,55,19,30,148,147,157,156,111,305,303,23236,3543490.0,22932,23103.75
483,55,48,20,31,215,214,148,147,289,363,361,31820,5775330.0,31458,32760.75
4830,49,41,13,26,109,108,141,140,95,250,248,15369,1921125.0,15120,15500.0
4831,51,41,18,34,154,153,185,184,212,339,337,28490,4829055.0,28152,28560.75
4832,77,63,20,43,178,177,157,156,227,335,333,27946,4680955.0,27612,27888.75
4833,49,41,12,25,212,211,123,122,143,335,333,26076,4367730.0,25742,27888.75
4835,43,36,13,21,223,222,268,267,563,491,489,59764,14672062.0,59274,60024.75
4836,72,65,16,28,269,268,275,274,761,544,542,73975,20121200.0,73432,73712.0
4837,43,34,9,25,166,165,105,104,88,271,269,17430,2361765.0,17160,18224.75
4838,45,35,14,31,187,186,177,176,241,364,362,33099,6024018.0,32736,32942.0
4839,50,45,17,23,218,217,108,107,166,326,324,23544,3837672.0,23219,26406.0
484,26,21,10,15,176,175,256,255,316,432,430,45056,9732096.0,44625,46440.0
4840,103,93,16,34,253,252,147,146,223,400,398,37191,7438200.0,36792,39800.0
4841,94,86,20,32,193,192,193,192,215,386,384,37249,7189057.0,36864,37056.0
4842,93,76,33,65,404,403,174,173,580,578,576,70296,20315544.0,69719,83232.0
4843,100,78,26,68,237,236,168,167,354,405,403,39816,8062740.0,39412,40803.75
4844,87,71,23,53,197,196,141,140,216,338,336,27777,4694313.0,27440,28392.0
4845,48,37,13,32,134,133,264,263,216,398,396,35376,7039824.0,34979,39402.0
4846,87,85,17,18,196,195,139,138,270,335,333,27244,4563370.0,26910,27888.75
4847,66,61,21,29,223,222,156,155,247,379,377,34788,6592326.0,34410,35720.75
4848,104,83,33,72,327,326,267,266,1098,594,592,87309,25930773.0,86716,87912.0
4849,51,43,12,23,161,160,115,114,92,276,274,18515,2555070.0,18240,18906.0
485,75,67,25,37,180,179,179,178,224,359,357,32220,5783490.0,31862,32040.75
4850,46,29,11,40,102,101,101,100,60,203,201,10302,1045653.0,10100,10200.75
4851,27,23,10,16,148,147,168,167,148,316,314,24864,3928512.0,24549,24806.0
4852,45,40,12,17,145,144,169,168,165,314,312,24505,3847285.0,24192,24492.0
4854,74,56,22,52,201,200,189,188,260,390,388,37989,7407855.0,37600,37830.0
4855,64,56,13,27,100,99,170,169,124,270,268,17000,2295000.0,16731,18090.0
4856,59,52,20,31,148,147,114,113,121,262,260,16872,2210232.0,16611,17030.0
4857,38,30,12,21,252,251,204,203,354,456,454,51408,11721024.0,50953,51756.0
4858,257,256,10,10,267,266,267,266,630,534,532,71289,19034163.0,70756,71022.0
4859,53,44,19,33,146,145,161,160,143,307,305,23506,3608171.0,23200,23408.75
486,80,68,20,41,185,184,150,149,156,335,333,27750,4648125.0,27416,27888.75
4860,51,46,20,28,147,146,222,221,207,369,367,32634,6020973.0,32266,33855.75
4861,53,46,20,30,285,284,158,157,257,443,441,45030,9974145.0,44588,48840.75
4862,50,45,13,21,146,145,143,142,139,289,287,20878,3016871.0,20590,20735.75
4863,70,59,16,33,188,187,282,281,375,470,468,53016,12458760.0,52547,54990.0
4864,79,62,26,56,270,269,391,390,1798,661,659,105570,34890885.0,104910,108899.75
4865,64,55,14,29,141,140,144,143,128,285,283,20304,2893320.0,20020,20163.75
4866,30,23,9,18,108,107,138,137,78,246,244,14904,1833192.0,14659,15006.0
4867,44,31,14,32,104,103,106,105,55,210,208,11024,1157520.0,10815,10920.0
4868,55,39,17,45,134,133,169,168,194,303,301,22646,3430869.0,22344,22800.75
4869,36,28,9,19,86,85,147,146,56,233,231,12642,1472793.0,12410,13455.75
487,22,21,4,4,171,170,156,155,134,327,325,26676,4361526.0,26350,26568.75
4870,42,34,15,29,132,131,101,100,62,233,231,13332,1553178.0,13100,13455.75
4871,72,60,20,42,172,171,163,162,232,335,333,28036,4696030.0,27702,27888.75
4872,30,24,10,18,237,236,156,155,260,393,391,36972,7264998.0,36580,38415.75
4873,63,54,17,33,150,149,116,115,134,266,264,17400,2314200.0,17135,17556.0
4874,98,82,38,68,335,334,454,453,2340,789,787,152090,59999505.0,151302,155235.75
4875,99,83,19,47,174,173,156,155,205,330,328,27144,4478760.0,26815,27060.0
4876,54,48,13,23,247,246,162,161,315,409,407,40014,8182863.0,39606,41615.75
4877,63,51,19,41,100,99,185,184,128,285,283,18500,2636250.0,18216,20163.75
4878,38,32,13,21,86,85,120,119,54,206,204,10320,1062960.0,10115,10506.0
4879,55,46,20,35,250,249,343,342,773,593,591,85750,25424875.0,85158,87615.75
488,45,35,14,26,134,133,139,138,116,273,271,18626,2542449.0,18354,18495.75
4880,53,47,16,26,169,168,134,133,144,303,301,22646,3430869.0,22344,22800.75
4881,76,65,31,46,257,256,266,265,710,523,521,68362,17876663.0,67840,68120.75
4882,65,59,15,24,132,131,178,177,157,310,308,23496,3641880.0,23187,23870.0
4883,54,44,18,35,453,452,282,281,1644,735,733,127746,46946655.0,127012,134688.75
4884,54,45,15,30,150,149,89,88,69,239,237,13350,1595325.0,13112,14160.75
4885,20,17,5,7,100,99,95,94,42,195,193,9500,926250.0,9306,9408.75
4886,51,47,12,18,256,255,137,136,249,393,391,35072,6891648.0,34680,38415.75
4887,90,68,25,67,219,218,173,172,247,392,390,37887,7425852.0,37496,38220.0
4888,29,22,10,18,236,235,142,141,258,378,376,33512,6333768.0,33135,35532.0
4889,96,76,25,57,207,206,202,201,287,409,407,41814,8550963.0,41406,41615.75
489,99,82,29,61,175,174,235,234,359,410,408,41125,8430625.0,40716,41820.0
4890,62,56,21,31,230,229,150,149,216,380,378,34500,6555000.0,34121,35910.0
4891,57,51,13,23,89,88,225,224,108,314,312,20025,3143925.0,19712,24492.0
4892,44,35,15,30,122,121,168,167,155,290,288,20496,2971920.0,20207,20880.0
4893,257,256,10,10,267,266,267,266,592,534,532,71289,19034163.0,70756,71022.0
4894,52,39,14,38,197,196,227,226,428,424,422,44719,9480428.0,44296,44732.0
4895,50,40,12,29,241,240,193,192,288,434,432,46513,10093321.0,46080,46872.0
4896,68,60,18,30,208,207,225,224,260,433,431,46800,10132200.0,46368,46655.75
4897,24,23,7,7,187,186,121,120,132,308,306,22627,3484558.0,22320,23562.0
4898,66,60,25,35,197,196,151,150,181,348,346,29747,5175978.0,29400,30102.0
4899,75,63,20,38,161,160,302,301,454,463,461,48622,11255993.0,48160,53360.75
49,26,21,5,9,101,100,166,165,106,267,265,16766,2238261.0,16500,17688.75
4900,48,42,15,25,346,345,486,485,3846,832,830,168156,69952896.0,167325,172640.0
4901,57,47,16,34,196,195,206,205,297,402,400,40376,8115576.0,39975,40200.0
4902,69,55,19,43,110,109,169,168,98,279,277,18590,2593305.0,18312,19320.75
4903,84,77,20,31,290,289,134,133,215,424,422,38860,8238320.0,38437,44732.0
4904,56,50,16,25,168,167,179,178,210,347,345,30072,5217492.0,29726,29928.75
4905,50,35,19,46,151,150,128,127,124,279,277,19328,2696256.0,19050,19320.75
4906,133,105,44,97,394,393,460,459,2813,854,852,181240,77389480.0,180387,181902.0
4907,76,68,20,34,213,212,188,187,305,401,399,40044,8028822.0,39644,39999.75
4908,38,32,15,23,139,138,165,164,158,304,302,22935,3486120.0,22632,22952.0
4909,40,32,16,29,131,130,229,228,227,360,358,29999,5399820.0,29640,32220.0
491,41,35,9,19,234,233,140,139,185,374,372,32760,6126120.0,32387,34782.0
4910,38,34,11,17,103,102,118,117,53,221,219,12154,1343017.0,11934,12099.75
4911,49,39,18,35,234,233,170,169,267,404,402,39780,8035560.0,39377,40602.0
4912,39,31,11,19,125,124,173,172,111,298,296,21625,3222125.0,21328,22052.0
4913,147,124,44,88,340,339,528,527,2086,868,866,179520,77911680.0,178653,187922.0
4914,57,46,17,35,198,197,119,118,131,317,315,23562,3734577.0,23246,24963.75
4916,128,98,52,109,410,409,377,376,1903,787,785,154570,60823295.0,153784,154448.75
4917,46,35,11,30,160,159,115,114,106,275,273,18400,2530000.0,18126,18768.75
4918,115,114,5,5,262,261,124,123,195,386,384,32488,6270184.0,32103,37056.0
4919,58,54,9,15,183,182,92,91,103,275,273,16836,2314950.0,16562,18768.75
492,36,32,11,17,183,182,104,103,101,287,285,19032,2731092.0,18746,20448.75
4920,67,54,21,45,181,180,305,304,547,486,484,55205,13414815.0,54720,58806.0
4921,171,170,7,7,178,177,178,177,178,356,354,31684,5639752.0,31329,31506.0
4922,139,120,52,85,344,343,291,290,1425,635,633,100104,31783020.0,99470,100488.75
4923,62,45,19,49,227,226,377,376,1285,604,602,85579,25844858.0,84976,90902.0
4924,50,40,13,31,108,107,98,97,43,206,204,10584,1090152.0,10379,10506.0
4925,89,78,30,49,192,191,255,254,311,447,445,48960,10942560.0,48514,49728.75
4926,51,41,17,33,294,293,222,221,572,516,514,65268,16839144.0,64753,66306.0
4927,63,55,17,31,121,120,136,135,116,257,255,16456,2114596.0,16200,16383.75
4928,125,102,42,84,265,264,404,403,957,669,667,107060,35811570.0,106392,111555.75
4929,87,69,27,53,296,295,400,399,1611,696,694,118400,41203200.0,117705,120756.0
493,37,32,14,21,109,108,164,163,129,273,271,17876,2440074.0,17604,18495.75
4930,28,21,7,13,149,148,125,124,104,274,272,18625,2551625.0,18352,18632.0
4931,92,78,32,58,220,219,273,272,546,493,491,60060,14804790.0,59568,60515.75
4932,70,59,21,40,193,192,207,206,449,400,398,39951,7990200.0,39552,39800.0
4933,28,26,8,10,146,145,290,289,356,436,434,42340,9230120.0,41905,47306.0
4934,58,51,18,30,166,165,125,124,139,291,289,20750,3019125.0,20460,21024.75
4935,55,45,19,32,123,122,250,249,259,373,371,30750,5734875.0,30378,34595.75
4936,68,56,23,44,148,147,162,161,213,310,308,23976,3716280.0,23667,23870.0
4937,51,43,13,27,115,114,101,100,79,216,214,11615,1254420.0,11400,11556.0
4938,55,44,12,30,131,130,152,151,144,283,281,19912,2817548.0,19630,19880.75
4939,61,45,17,41,169,168,122,121,112,291,289,20618,2999919.0,20328,21024.75
494,65,53,20,40,193,192,122,121,166,315,313,23546,3708495.0,23232,24648.75
4940,63,54,19,34,234,233,155,154,239,389,387,36270,7054515.0,35882,37635.75
4941,49,43,15,25,143,142,206,205,167,349,347,29458,5140421.0,29110,30275.75
4942,46,35,16,35,128,127,121,120,101,249,247,15488,1928256.0,15240,15375.75
4943,59,50,14,28,186,185,212,211,324,398,396,39432,7846968.0,39035,39402.0
4944,90,70,30,63,259,258,272,271,461,531,529,70448,18703944.0,69918,70224.75
4945,116,93,50,94,427,426,469,468,4372,896,894,200263,89717824.0,199368,200256.0
4946,54,40,15,41,80,79,111,110,48,191,189,8880,848040.0,8690,9024.75
4947,36,31,7,15,108,107,198,197,201,306,304,21384,3271752.0,21079,23256.0
4949,64,51,24,48,156,155,112,111,106,268,266,17472,2341248.0,17205,17822.0
495,70,54,22,52,303,302,164,163,399,467,465,49692,11603082.0,49226,54288.75
4950,24,22,8,9,145,144,102,101,75,247,245,14790,1826565.0,14544,15128.75
4951,80,60,24,61,174,173,253,252,395,427,425,44022,9398697.0,43596,45368.75
4952,38,34,10,14,164,163,179,178,188,343,341,29356,5034554.0,29014,29240.75
4953,67,64,13,17,184,183,118,117,125,302,300,21712,3278512.0,21411,22650.0
4954,47,34,14,37,191,190,362,361,902,553,551,69142,19117763.0,68590,76175.75
4955,20,18,6,7,366,365,141,140,455,507,505,51606,13082121.0,51100,64008.75
4956,25,20,10,17,200,199,162,161,213,362,360,32400,5864400.0,32039,32580.0
4957,44,39,13,20,146,145,124,123,114,270,268,18104,2444040.0,17835,18090.0
4958,70,54,17,47,138,137,137,136,130,275,273,18906,2599575.0,18632,18768.75
4959,91,69,35,77,249,248,477,476,1586,726,724,118773,43114599.0,118048,131406.0
496,69,50,27,61,245,244,191,190,638,436,434,46795,10201310.0,46360,47306.0
4960,41,36,17,23,210,209,183,182,235,393,391,38430,7551495.0,38038,38415.75
4961,65,59,16,26,141,140,148,147,103,289,287,20868,3015426.0,20580,20735.75
4962,57,52,15,22,136,135,108,107,72,244,242,14688,1791936.0,14445,14762.0
4963,104,81,31,75,346,345,197,196,692,543,541,68162,18505983.0,67620,73440.75
4964,57,48,17,30,114,113,97,96,71,211,209,11058,1166619.0,10848,11024.75
4965,51,39,8,20,143,142,94,93,92,237,235,13442,1592877.0,13206,13923.75
4966,51,38,16,40,181,180,131,130,134,312,310,23711,3698916.0,23400,24180.0
4967,44,34,10,26,135,134,106,105,71,241,239,14310,1724355.0,14070,14399.75
4968,55,45,13,31,129,128,194,193,181,323,321,25026,4041699.0,24704,25920.75
4969,37,30,11,21,142,141,125,124,103,267,265,17750,2369625.0,17484,17688.75
497,66,58,22,35,201,200,118,117,136,319,317,23718,3783021.0,23400,25280.75
4970,67,56,19,38,138,137,132,131,95,270,268,18216,2459160.0,17947,18090.0
4971,77,64,31,55,263,262,287,286,584,550,548,75481,20757275.0,74932,75350.0
4972,24,23,6,6,96,95,123,122,85,219,217,11808,1292976.0,11590,11880.75
4973,58,45,18,41,121,120,171,170,162,292,290,20691,3020886.0,20400,21170.0
4974,29,20,7,23,194,193,210,209,381,404,402,40740,8229480.0,40337,40602.0
4976,40,35,12,18,87,86,201,200,124,288,286,17487,2518128.0,17200,20592.0
4977,27,23,9,14,122,121,131,130,88,253,251,15982,2021723.0,15730,15875.75
4978,71,58,28,51,233,232,140,139,208,373,371,32620,6083630.0,32248,34595.75
4979,53,47,22,32,213,212,251,250,558,464,462,53463,12403416.0,53000,53592.0
498,67,62,24,32,226,225,130,129,172,356,354,29380,5229640.0,29025,31506.0
4980,76,69,26,37,232,231,301,300,762,533,531,69832,18610228.0,69300,70755.75
4981,146,119,46,98,424,423,295,294,1488,719,717,125080,44966260.0,124362,128880.75
4982,48,38,16,32,128,127,136,135,101,264,262,17408,2297856.0,17145,17292.0
4984,28,23,9,14,88,87,107,106,38,195,193,9416,918060.0,9222,9408.75
4985,118,102,41,70,365,364,300,299,972,665,663,109500,36408750.0,108836,110223.75
4986,23,19,8,13,98,97,121,120,71,219,217,11858,1298451.0,11640,11880.75
4987,45,33,15,36,186,185,97,96,84,283,281,18042,2552943.0,17760,19880.75
4988,61,58,17,21,123,122,178,177,94,301,299,21894,3295047.0,21594,22499.75
4989,44,40,14,20,335,334,199,198,536,534,532,66665,17799555.0,66132,71022.0
499,120,80,34,110,278,277,329,328,1930,607,605,91462,27758717.0,90856,91808.75
4990,41,34,13,25,97,96,191,190,97,288,286,18527,2667888.0,18240,20592.0
4991,73,56,26,53,283,282,215,214,610,498,496,60845,15150405.0,60348,61752.0
4992,95,76,26,60,197,196,206,205,292,403,401,40582,8177273.0,40180,40400.75
4993,230,218,18,39,425,424,283,282,1881,708,706,120275,42577350.0,119568,124962.0
4994,185,160,39,86,324,323,391,390,1645,715,713,126684,45289530.0,125970,127448.75
4995,54,48,15,24,128,127,111,110,67,239,237,14208,1697856.0,13970,14160.75
4996,72,62,21,39,134,133,295,294,333,429,427,39530,8479185.0,39102,45795.75
4997,58,47,19,38,120,119,167,166,147,287,285,20040,2875740.0,19754,20448.75
4998,90,82,28,41,239,238,235,234,483,474,472,56165,13311105.0,55692,55932.0
4999,74,66,20,31,180,179,108,107,111,288,286,19440,2799360.0,19153,20592.0
5,83,71,27,49,144,143,224,223,188,368,366,32256,5935104.0,31889,33672.0
50,52,42,16,33,125,124,147,146,101,272,270,18375,2499000.0,18104,18360.0
500,53,44,17,33,203,202,198,197,252,401,399,40194,8058897.0,39794,39999.75
5000,82,70,21,43,213,212,118,117,144,331,329,25134,4159677.0,24804,27224.75
5001,65,39,16,64,154,153,173,172,167,327,325,26642,4355967.0,26316,26568.75
5002,48,43,14,20,210,209,170,169,257,380,378,35700,6783000.0,35321,35910.0
5003,95,73,36,78,244,243,207,206,495,451,449,50508,11389554.0,50058,50624.75
5004,65,55,17,35,188,187,199,198,285,387,385,37412,7239222.0,37026,37248.75
5006,79,63,23,52,152,151,147,146,176,299,297,22344,3340428.0,22046,22200.75
5007,28,27,8,8,169,168,262,261,245,431,429,44278,9541909.0,43848,46224.75
5009,83,62,26,63,132,131,158,157,136,290,288,20856,3024120.0,20567,20880.0
501,49,42,18,30,151,150,141,140,124,292,290,21291,3108486.0,21000,21170.0
5010,55,49,21,30,229,228,132,131,159,361,359,30228,5456154.0,29868,32399.75
5011,53,45,23,36,192,191,132,131,165,324,322,25344,4105728.0,25021,26082.0
5012,79,72,18,26,145,144,145,144,147,290,288,21025,3048625.0,20736,20880.0
5014,69,57,14,36,180,179,123,122,114,303,301,22140,3354210.0,21838,22800.75
5015,95,73,30,70,205,204,183,182,339,388,386,37515,7277910.0,37128,37442.0
5016,29,26,11,14,198,197,190,189,322,388,386,37620,7298280.0,37233,37442.0
5017,34,25,8,24,139,138,114,113,106,253,251,15846,2004519.0,15594,15875.75
5018,40,33,13,23,96,95,144,143,99,240,238,13824,1658880.0,13585,14280.0
5019,89,65,28,72,240,239,297,296,529,537,535,71280,19138680.0,70744,71823.75
5020,78,68,19,36,201,200,140,139,164,341,339,28140,4797870.0,27800,28899.75
5021,79,71,21,34,262,261,307,306,800,569,567,80434,22883473.0,79866,80655.75
5022,25,24,6,6,103,102,110,109,62,213,211,11330,1206645.0,11118,11235.75
5023,25,20,8,13,119,118,98,97,45,217,215,11662,1265327.0,11446,11663.75
5024,45,34,12,31,307,306,375,374,1070,682,680,115125,39257625.0,114444,115940.0
5025,40,35,11,19,86,85,193,192,90,279,277,16598,2315421.0,16320,19320.75
5026,43,42,13,13,169,168,139,138,132,308,306,23491,3617614.0,23184,23562.0
5028,100,83,20,52,196,195,161,160,269,357,355,31556,5632746.0,31200,31683.75
5029,72,56,21,49,150,149,136,135,135,286,284,20400,2917200.0,20115,20306.0
503,42,26,10,40,237,236,340,339,1039,577,575,80580,23247330.0,80004,82943.75
5030,364,350,12,38,377,376,405,404,2433,782,780,152685,59699835.0,151904,152490.0
5031,47,44,12,15,74,73,129,128,62,203,201,9546,968919.0,9344,10200.75
5032,56,48,17,30,142,141,100,99,78,242,240,14200,1718200.0,13959,14520.0
5033,25,22,8,11,171,170,123,122,100,294,292,21033,3091851.0,20740,21462.0
5034,67,60,21,33,146,145,179,178,132,325,323,26134,4246775.0,25810,26243.75
5035,257,256,10,10,267,266,267,266,597,534,532,71289,19034163.0,70756,71022.0
5036,58,51,19,31,206,205,196,195,314,402,400,40376,8115576.0,39975,40200.0
5037,30,26,6,11,114,113,120,119,78,234,232,13680,1600560.0,13447,13572.0
5038,58,53,18,26,175,174,142,141,127,317,315,24850,3938725.0,24534,24963.75
5039,52,46,16,26,147,146,122,121,84,269,267,17934,2412123.0,17666,17955.75
504,60,35,13,49,176,175,134,133,156,310,308,23584,3655520.0,23275,23870.0
5040,47,37,16,32,214,213,123,122,163,337,335,26322,4435257.0,25986,28223.75
5041,68,61,21,33,164,163,154,153,123,318,316,25256,4015704.0,24939,25122.0
5042,58,40,15,45,148,147,110,109,102,258,256,16280,2100120.0,16023,16512.0
5043,56,40,16,45,186,185,242,241,383,428,426,45012,9632568.0,44585,45582.0
5044,76,60,22,52,120,119,194,193,252,314,312,23280,3654960.0,22967,24492.0
5045,82,75,20,32,186,185,169,168,194,355,353,31434,5579535.0,31080,31328.75
5046,58,52,17,27,112,111,93,92,56,205,203,10416,1067640.0,10212,10403.75
5047,44,30,11,36,147,146,222,221,302,369,367,32634,6020973.0,32266,33855.75
5048,49,39,15,32,203,202,161,160,174,364,362,32683,5948306.0,32320,32942.0
5049,47,42,16,22,139,138,315,314,399,454,452,43785,9939195.0,43332,51302.0
505,47,38,21,36,433,432,329,328,1871,762,760,142457,54276117.0,141696,144780.0
5050,100,85,37,65,303,302,200,199,467,503,501,60600,15240900.0,60098,63000.75
5051,66,61,19,26,171,170,169,168,158,340,338,28899,4912830.0,28560,28730.0
5052,51,39,13,32,126,125,108,107,92,234,232,13608,1592136.0,13375,13572.0
5053,50,36,18,41,240,239,228,227,394,468,466,54720,12804480.0,54253,54522.0
5054,118,99,29,65,421,420,229,228,843,650,648,96409,31332925.0,95760,105300.0
5055,98,83,26,54,267,266,220,219,571,487,485,58740,14303190.0,58254,59048.75
5056,39,35,14,19,189,188,161,160,169,350,348,30429,5325075.0,30080,30450.0
5057,76,55,22,56,217,216,211,210,351,428,426,45787,9798418.0,45360,45582.0
5058,44,39,13,21,191,190,171,170,267,362,360,32661,5911641.0,32300,32580.0
5059,56,51,13,20,128,127,110,109,95,238,236,14080,1675520.0,13843,14042.0
506,58,42,15,42,264,263,158,157,291,422,420,41712,8801232.0,41291,44310.0
5060,180,159,38,78,259,258,359,358,1272,618,616,92981,28731129.0,92364,95172.0
5061,24,22,8,10,146,145,79,78,48,225,223,11534,1297575.0,11310,12543.75
5062,53,47,18,24,112,111,171,170,101,283,281,19152,2710008.0,18870,19880.75
5063,46,40,14,24,138,137,92,91,56,230,228,12696,1460040.0,12467,13110.0
5064,70,60,15,33,199,198,120,119,146,319,317,23880,3808860.0,23562,25280.75
5065,52,45,11,23,171,170,173,172,203,344,342,29583,5088276.0,29240,29412.0
5066,73,55,20,50,171,170,154,153,174,325,323,26334,4279275.0,26010,26243.75
5067,86,71,20,48,164,163,127,126,123,291,289,20828,3030474.0,20538,21024.75
5068,62,51,20,36,369,368,157,156,476,526,524,57933,15236379.0,57408,68906.0
5069,57,46,18,33,114,113,165,164,137,279,277,18810,2623995.0,18532,19320.75
507,45,32,12,34,87,86,96,95,47,183,181,8352,764208.0,8170,8280.75
5070,102,85,33,64,355,354,275,274,856,630,628,97625,30751875.0,96996,98910.0
5071,50,43,15,27,253,252,450,449,1024,703,701,113850,40018275.0,113148,123200.75
5072,99,76,34,78,229,228,289,288,677,518,516,66181,17140879.0,65664,66822.0
5073,41,31,6,16,93,92,88,87,36,181,179,8184,740652.0,8004,8099.75
5074,89,78,25,45,238,237,138,137,201,376,374,32844,6174672.0,32469,35156.0
5075,110,84,35,83,389,388,293,292,1240,682,680,113977,38866157.0,113296,115940.0
5076,55,52,13,17,130,129,130,129,112,260,258,16900,2197000.0,16641,16770.0
5077,55,50,17,25,359,358,253,252,834,612,610,90827,27793062.0,90216,93330.0
5078,119,115,13,19,147,146,178,177,177,325,323,26166,4251975.0,25842,26243.75
5079,52,43,16,32,162,161,154,153,155,316,314,24948,3941784.0,24633,24806.0
508,112,107,11,18,178,177,193,192,274,371,369,34354,6372667.0,33984,34224.75
5080,38,25,10,32,137,136,172,171,250,309,307,23564,3640638.0,23256,23715.75
5081,123,104,35,71,228,227,310,309,637,538,536,70680,19012920.0,70143,72092.0
5082,61,50,20,38,166,165,229,228,225,395,393,38014,7507765.0,37620,38808.75
5083,59,47,14,35,167,166,143,142,200,310,308,23881,3701555.0,23572,23870.0
5084,62,51,16,34,191,190,163,162,357,354,352,31133,5510541.0,30780,31152.0
5085,26,23,7,9,289,288,228,227,452,517,515,65892,17033082.0,65376,66563.75
5086,72,63,28,44,164,163,155,154,155,319,317,25420,4054490.0,25102,25280.75
5087,27,20,9,19,335,334,188,187,503,523,521,62980,16469270.0,62458,68120.75
5088,22,21,4,4,99,98,90,89,39,189,187,8910,841995.0,8722,8835.75
5089,79,68,25,44,269,268,402,401,1092,671,669,108138,36280299.0,107468,112224.75
509,38,33,8,15,104,103,126,125,53,230,228,13104,1506960.0,12875,13110.0
5090,71,59,24,44,178,177,189,188,330,367,365,33642,6173307.0,33276,33488.75
5091,44,38,14,24,119,118,101,100,53,220,218,12019,1322090.0,11800,11990.0
5092,97,80,30,62,195,194,276,275,442,471,469,53820,12674610.0,53350,55224.75
5093,27,18,7,19,159,158,123,122,134,282,280,19557,2757537.0,19276,19740.0
5094,57,53,12,18,196,195,123,122,161,319,317,24108,3845226.0,23790,25280.75
5095,38,33,11,15,165,164,175,174,196,340,338,28875,4908750.0,28536,28730.0
5096,113,97,36,66,215,214,474,473,982,689,687,101910,35107995.0,101222,118335.75
5097,112,91,33,73,261,260,208,207,299,469,467,54288,12730536.0,53820,54755.75
5098,76,65,24,44,130,129,203,202,184,333,331,26390,4393935.0,26058,27555.75
5099,88,73,31,59,188,187,164,163,248,352,350,30832,5426432.0,30481,30800.0
51,68,45,20,64,159,158,235,234,249,394,392,37365,7360905.0,36972,38612.0
510,30,27,11,15,389,388,485,484,2851,874,872,188665,82446605.0,187792,190532.0
5100,78,65,23,40,155,154,188,187,226,343,341,29140,4997510.0,28798,29240.75
5101,35,30,11,19,140,139,73,72,51,213,211,10220,1088430.0,10008,11235.75
5102,61,57,15,21,139,138,125,124,96,264,262,17375,2293500.0,17112,17292.0
5103,62,51,14,34,100,99,121,120,59,221,219,12100,1337050.0,11880,12099.75
5104,36,28,11,24,157,156,347,346,535,504,502,54479,13728708.0,53976,63252.0
5105,119,99,38,74,301,300,222,221,508,523,521,66822,17473953.0,66300,68120.75
5106,24,22,9,11,102,101,106,105,59,208,206,10812,1124448.0,10605,10712.0
5107,61,55,18,28,132,131,251,250,299,383,381,33132,6344778.0,32750,36480.75
5108,80,57,27,71,242,241,289,288,724,531,529,69938,18568539.0,69408,70224.75
5109,46,30,12,38,168,167,103,102,105,271,269,17304,2344692.0,17034,18224.75
511,46,31,12,32,143,142,146,145,148,289,287,20878,3016871.0,20590,20735.75
5110,171,170,7,7,178,177,178,177,172,356,354,31684,5639752.0,31329,31506.0
5111,57,49,18,31,126,125,182,181,129,308,306,22932,3531528.0,22625,23562.0
5112,36,30,13,23,163,162,111,110,91,274,272,18093,2478741.0,17820,18632.0
5113,68,54,20,44,208,207,277,276,480,485,483,57616,13971880.0,57132,58563.75
5114,67,60,14,26,100,99,265,264,151,365,363,26500,4836250.0,26136,33123.75
5115,46,45,5,5,190,189,324,323,540,514,512,61560,15820920.0,61047,65792.0
5116,38,27,9,20,129,128,108,107,90,237,235,13932,1650942.0,13696,13923.75
5117,33,29,11,15,240,239,278,277,386,518,516,66720,17280480.0,66203,66822.0
5118,55,47,19,32,156,155,124,123,121,280,278,19344,2708160.0,19065,19460.0
5119,88,78,30,48,246,245,206,205,354,452,450,50676,11452776.0,50225,50850.0
512,85,79,25,34,139,138,267,266,298,406,404,37113,7533939.0,36708,41006.0
5120,109,87,32,74,251,250,268,267,479,519,517,67268,17456046.0,66750,67080.75
5121,105,80,29,77,285,284,202,201,441,487,485,57570,14018295.0,57084,59048.75
5122,68,59,18,34,106,105,162,161,158,268,266,17172,2301048.0,16905,17822.0
5123,65,57,26,36,260,259,243,242,552,503,501,63180,15889770.0,62678,63000.75
5125,68,63,12,19,147,146,93,92,62,240,238,13671,1640520.0,13432,14280.0
5126,46,37,14,29,304,303,289,288,967,593,591,87856,26049304.0,87264,87615.75
5127,60,46,20,45,166,165,156,155,195,322,320,25896,4169256.0,25575,25760.0
5128,52,47,22,29,121,120,155,154,106,276,274,18755,2588190.0,18480,18906.0
5129,69,61,20,34,377,376,139,138,458,516,514,52403,13519974.0,51888,66306.0
513,59,52,18,30,184,183,267,266,404,451,449,49128,11078364.0,48678,50624.75
5130,220,206,36,62,269,268,447,446,1500,716,714,120243,43046994.0,119528,127806.0
5131,44,38,10,16,142,141,198,197,134,340,338,28116,4779720.0,27777,28730.0
5132,29,18,8,27,164,163,121,120,127,285,283,19844,2827770.0,19560,20163.75
5133,134,119,29,54,478,477,343,342,2861,821,819,163954,67303117.0,163134,168099.75
5134,53,47,16,26,364,363,264,263,645,628,626,96096,30174144.0,95469,98282.0
5136,55,40,18,43,219,218,194,193,268,413,411,42486,8773359.0,42074,42435.75
5137,49,43,14,24,115,114,93,92,50,208,206,10695,1112280.0,10488,10712.0
5138,49,45,13,19,156,155,157,156,155,313,311,24492,3832998.0,24180,24335.75
5139,39,31,12,26,275,274,141,140,314,416,414,38775,8065200.0,38360,43056.0
514,95,85,19,37,226,225,204,203,562,430,428,46104,9912360.0,45675,46010.0
5140,62,59,12,16,115,114,129,128,76,244,242,14835,1809870.0,14592,14762.0
5142,41,36,14,21,276,275,156,155,336,432,430,43056,9300096.0,42625,46440.0
5143,59,48,13,28,167,166,103,102,77,270,268,17201,2322135.0,16932,18090.0
5144,54,47,18,29,177,176,170,169,190,347,345,30090,5220615.0,29744,29928.75
5145,93,82,13,27,187,186,137,136,172,324,322,25619,4150278.0,25296,26082.0
5146,68,57,20,37,150,149,165,164,196,315,313,24750,3898125.0,24436,24648.75
5147,74,56,22,54,234,233,175,174,400,409,407,40950,8374275.0,40542,41615.75
5148,122,117,14,22,178,177,147,146,194,325,323,26166,4251975.0,25842,26243.75
5149,275,251,47,93,447,446,426,425,5006,873,871,190422,83119203.0,189550,190095.75
515,76,55,23,59,147,146,171,170,204,318,316,25137,3996783.0,24820,25122.0
5150,56,46,15,31,171,170,107,106,127,278,276,18297,2543283.0,18020,19182.0
5151,36,30,11,19,148,147,77,76,47,225,223,11396,1282050.0,11172,12543.75
5152,50,43,18,28,95,94,141,140,66,236,234,13395,1580610.0,13160,13806.0
5153,42,34,11,25,100,99,167,166,113,267,265,16700,2229450.0,16434,17688.75
5154,17,16,4,4,196,195,66,65,73,262,260,12936,1694616.0,12675,17030.0
5155,63,52,19,34,221,220,165,164,230,386,384,36465,7037745.0,36080,37056.0
5156,43,39,17,23,253,252,429,428,1243,682,680,108537,37011117.0,107856,115940.0
5157,81,70,22,40,170,169,148,147,155,318,316,25160,4000440.0,24843,25122.0
5158,45,38,12,24,171,170,98,97,90,269,267,16758,2253951.0,16490,17955.75
5159,89,77,27,49,197,196,271,270,405,468,466,53387,12492558.0,52920,54522.0
516,52,43,15,29,112,111,148,147,104,260,258,16576,2154880.0,16317,16770.0
5160,107,91,27,57,281,280,288,287,576,569,567,80928,23024016.0,80360,80655.75
5161,44,37,15,25,95,94,110,109,64,205,203,10450,1071125.0,10246,10403.75
5162,109,103,10,20,216,215,178,177,287,394,392,38448,7574256.0,38055,38612.0
5163,106,102,10,16,262,261,178,177,370,440,438,46636,10259920.0,46197,48180.0
5164,122,106,38,66,346,345,390,389,1200,736,734,134940,49657920.0,134205,135056.0
5165,51,36,14,28,132,131,138,137,117,270,268,18216,2459160.0,17947,18090.0
5166,105,101,10,16,124,123,178,177,111,302,300,22072,3332872.0,21771,22650.0
5167,90,78,26,46,175,174,267,266,392,442,440,46725,10326225.0,46284,48620.0
5168,51,38,13,35,81,80,138,137,69,219,217,11178,1223991.0,10960,11880.75
5169,119,105,28,54,206,205,251,250,493,457,455,51706,11814821.0,51250,51983.75
517,55,45,18,34,262,261,186,185,358,448,446,48732,10915968.0,48285,49952.0
5170,62,51,16,35,184,183,111,110,159,295,293,20424,3012540.0,20130,21608.75
5171,49,35,16,41,134,133,115,114,79,249,247,15410,1918545.0,15162,15375.75
5172,107,83,35,81,336,335,216,215,670,552,550,72576,20030976.0,72025,75900.0
5173,18,17,4,4,137,136,243,242,195,380,378,33291,6325290.0,32912,35910.0
5174,51,41,17,34,153,152,171,170,168,324,322,26163,4238406.0,25840,26082.0
5175,48,45,14,17,121,120,177,176,175,298,296,21417,3191133.0,21120,22052.0
5176,39,37,8,9,77,76,137,136,51,214,212,10549,1128743.0,10336,11342.0
5177,95,76,25,61,284,283,259,258,588,543,541,73556,19970454.0,73014,73440.75
5178,76,62,22,48,186,185,172,171,252,358,356,31992,5726568.0,31635,31862.0
5179,56,51,20,28,150,149,153,152,118,303,301,22950,3476925.0,22648,22800.75
5180,112,89,32,74,259,258,268,267,512,527,525,69412,18290062.0,68886,69168.75
5181,52,39,13,37,87,86,128,127,54,215,213,11136,1197120.0,10922,11448.75
5182,47,42,16,24,284,283,133,132,244,417,415,37772,7875462.0,37356,43263.75
5183,51,40,11,29,105,104,91,90,63,196,194,9555,936390.0,9360,9506.0
5184,182,152,44,100,342,341,391,390,1572,733,731,133722,49009113.0,132990,133955.75
5185,110,80,30,86,424,423,229,228,1000,653,651,97096,31701844.0,96444,106275.75
5186,78,63,25,52,146,145,196,195,306,342,340,28616,4893336.0,28275,29070.0
5187,63,58,18,26,100,99,120,119,54,220,218,12000,1320000.0,11781,11990.0
5188,30,26,5,8,143,142,77,76,75,220,218,11011,1211210.0,10792,11990.0
5189,94,74,31,66,471,470,369,368,2432,840,838,173799,72995580.0,172960,175980.0
519,66,56,21,33,294,293,238,237,1016,532,530,69972,18612552.0,69441,70490.0
5190,93,74,32,68,288,287,338,337,1289,626,624,97344,30468672.0,96719,97656.0
5191,31,28,13,17,144,143,184,183,172,328,326,26496,4345344.0,26169,26732.0
5192,57,49,16,26,128,127,203,202,139,331,329,25984,4300352.0,25654,27224.75
5193,58,43,20,47,149,148,133,132,124,282,280,19817,2794197.0,19536,19740.0
5194,98,97,4,4,170,169,124,123,105,294,292,21080,3098760.0,20787,21462.0
5195,44,32,13,35,176,175,152,151,191,328,326,26752,4387328.0,26425,26732.0
5196,65,61,21,27,160,159,94,93,79,254,252,15040,1910080.0,14787,16002.0
5197,99,97,8,10,239,238,178,177,276,417,415,42542,8870007.0,42126,43263.75
5198,35,25,9,21,103,102,85,84,41,188,186,8755,822970.0,8568,8742.0
5199,34,30,11,16,230,229,236,235,498,466,464,54280,12647240.0,53815,54056.0
52,43,38,10,18,123,122,88,87,42,211,209,10824,1141932.0,10614,11024.75
520,100,98,9,11,178,177,285,284,421,463,461,50730,11743995.0,50268,53360.75
5200,52,42,19,33,292,291,208,207,466,500,498,60736,15184000.0,60237,62250.0
5201,80,75,18,26,225,224,144,143,189,369,367,32400,5977800.0,32032,33855.75
5202,55,47,22,36,304,303,307,306,542,611,609,93328,28511704.0,92718,93024.75
5203,44,37,19,29,93,92,147,146,60,240,238,13671,1640520.0,13432,14280.0
5204,63,54,17,33,108,107,141,140,83,249,247,15228,1895886.0,14980,15375.75
5206,29,26,7,11,170,169,141,140,111,311,309,23970,3727335.0,23660,24024.75
5207,53,48,20,28,204,203,343,342,555,547,545,69972,19137342.0,69426,74528.75
5208,62,57,12,19,178,177,158,157,136,336,334,28124,4724832.0,27789,28056.0
5209,66,61,18,26,232,231,158,157,239,390,388,36656,7147920.0,36267,37830.0
521,74,62,22,43,221,220,158,157,222,379,377,34918,6616961.0,34540,35720.75
5210,41,34,13,25,109,108,178,177,133,287,285,19402,2784187.0,19116,20448.75
5211,77,68,24,39,164,163,180,179,255,344,342,29520,5077440.0,29177,29412.0
5212,22,21,5,5,112,111,133,132,66,245,243,14896,1824760.0,14652,14883.75
5213,64,57,23,34,149,148,118,117,97,267,265,17582,2347197.0,17316,17688.75
5214,32,26,12,22,123,122,118,117,97,241,239,14514,1748937.0,14274,14399.75
5215,85,68,33,61,259,258,240,239,406,499,497,62160,15508920.0,61662,62000.75
5216,53,42,15,35,143,142,115,114,93,258,256,16445,2121405.0,16188,16512.0
5217,44,33,9,27,123,122,90,89,62,213,211,11070,1178955.0,10858,11235.75
5218,49,42,15,25,352,351,191,190,752,543,541,67232,18253488.0,66690,73440.75
5219,44,33,12,31,140,139,102,101,86,242,240,14280,1727880.0,14039,14520.0
522,33,23,10,26,128,127,156,155,159,284,282,19968,2835456.0,19685,20022.0
5220,112,91,36,73,269,268,337,336,923,606,604,90653,27467859.0,90048,91506.0
5221,58,46,19,41,158,157,118,117,117,276,274,18644,2572872.0,18369,18906.0
5222,70,58,20,41,149,148,204,203,244,353,351,30396,5364894.0,30044,30975.75
5223,21,18,7,10,146,145,147,146,105,293,291,21462,3144183.0,21170,21315.75
5224,84,71,23,46,180,179,147,146,137,327,325,26460,4326210.0,26134,26568.75
5225,58,50,17,31,177,176,107,106,123,284,282,18939,2689338.0,18656,20022.0
5226,95,82,29,53,481,480,358,357,2117,839,837,172198,72237061.0,171360,175560.75
5227,43,40,13,16,96,95,136,135,70,232,230,13056,1514496.0,12825,13340.0
5228,53,49,16,22,202,201,129,128,158,331,329,26058,4312599.0,25728,27224.75
5229,31,30,10,10,119,118,191,190,147,310,308,22729,3522995.0,22420,23870.0
523,65,54,15,32,125,124,147,146,153,272,270,18375,2499000.0,18104,18360.0
5230,68,52,17,46,138,137,127,126,106,265,263,17526,2322195.0,17262,17423.75
5231,60,45,17,41,109,108,123,122,71,232,230,13407,1555212.0,13176,13340.0
5232,89,76,24,46,161,160,251,250,315,412,410,40411,8324666.0,40000,42230.0
5234,62,55,18,30,135,134,171,170,121,306,304,23085,3532005.0,22780,23256.0
5235,108,90,31,65,346,345,195,194,477,541,539,67470,18250635.0,66930,72899.75
5236,37,35,12,13,113,112,191,190,106,304,302,21583,3280616.0,21280,22952.0
5237,65,53,17,37,200,199,215,214,366,415,413,43000,8922500.0,42586,42848.75
5238,43,38,12,16,119,118,163,162,129,282,280,19397,2734977.0,19116,19740.0
5239,80,78,20,22,191,190,201,200,240,392,390,38391,7524636.0,38000,38220.0
524,48,44,15,21,189,188,367,366,739,556,554,69363,19282914.0,68808,77006.0
5240,69,59,25,42,215,214,279,278,431,494,492,59985,14816295.0,59492,60762.0
5241,97,89,11,25,229,228,269,268,513,498,496,61601,15338649.0,61104,61752.0
5242,27,24,9,13,111,110,171,170,129,282,280,18981,2676321.0,18700,19740.0
5243,28,26,10,11,92,91,120,119,46,212,210,11040,1170240.0,10829,11130.0
5244,28,24,9,14,351,350,166,165,554,517,515,58266,15061761.0,57750,66563.75
5245,48,39,11,27,92,91,101,100,53,193,191,9292,896678.0,9100,9215.75
5246,87,81,22,32,201,200,161,160,165,362,360,32361,5857341.0,32000,32580.0
5247,41,33,14,28,172,171,147,146,167,319,317,25284,4032798.0,24966,25280.75
5248,73,57,22,52,198,197,138,137,188,336,334,27324,4590432.0,26989,28056.0
5249,39,36,10,13,123,122,126,125,96,249,247,15498,1929501.0,15250,15375.75
525,68,56,21,42,142,141,218,217,164,360,358,30956,5572080.0,30597,32220.0
5250,62,46,21,47,195,194,168,167,204,363,361,32760,5945940.0,32398,32760.75
5251,87,71,28,58,260,259,229,228,524,489,487,59540,14557530.0,59052,59535.75
5252,46,43,15,19,127,126,233,232,282,360,358,29591,5326380.0,29232,32220.0
5254,56,49,17,29,213,212,101,100,125,314,312,21513,3377541.0,21200,24492.0
5255,64,57,18,30,130,129,149,148,154,279,277,19370,2702115.0,19092,19320.75
5256,45,42,14,18,129,128,124,123,80,253,251,15996,2023494.0,15744,15875.75
5257,46,31,8,25,182,181,125,124,157,307,305,22750,3492125.0,22444,23408.75
5258,46,43,11,15,129,128,89,88,51,218,216,11481,1251429.0,11264,11772.0
5259,61,52,16,29,241,240,251,250,835,492,490,60491,14880786.0,60000,60270.0
526,29,26,9,12,172,171,111,110,99,283,281,19092,2701518.0,18810,19880.75
5260,73,64,20,36,152,151,134,133,163,286,284,20368,2912624.0,20083,20306.0
5261,53,47,10,20,235,234,242,241,507,477,475,56870,13563495.0,56394,56643.75
5262,82,73,19,35,182,181,307,306,538,489,487,55874,13661193.0,55386,59535.75
5263,100,85,29,57,414,413,467,466,4371,881,879,193338,85165389.0,192458,193599.75
5264,64,56,16,30,134,133,139,138,88,273,271,18626,2542449.0,18354,18495.75
5265,225,210,38,66,269,268,447,446,1525,716,714,120243,43046994.0,119528,127806.0
5266,35,29,10,18,233,232,195,194,454,428,426,45435,9723090.0,45008,45582.0
5267,73,60,22,36,171,170,172,171,217,343,341,29412,5044158.0,29070,29240.75
5268,30,27,10,14,415,414,317,316,1506,732,730,131555,48149130.0,130824,133590.0
5269,71,54,22,46,146,145,237,236,313,383,381,34602,6626283.0,34220,36480.75
527,34,24,8,18,163,162,167,166,171,330,328,27221,4491465.0,26892,27060.0
5271,42,40,8,9,72,71,145,144,48,217,215,10440,1132740.0,10224,11663.75
5272,34,31,9,13,169,168,101,100,88,270,268,17069,2304315.0,16800,18090.0
5273,89,74,28,56,224,223,171,170,208,395,393,38304,7565040.0,37910,38808.75
5274,48,43,12,18,87,86,188,187,97,275,273,16356,2248950.0,16082,18768.75
5275,62,52,19,37,512,511,274,273,2818,786,784,140288,55133184.0,139503,154056.0
5277,110,91,31,66,200,199,267,266,490,467,465,53400,12468900.0,52934,54288.75
5278,122,110,21,40,188,187,255,254,496,443,441,47940,10618710.0,47498,48840.75
5279,54,41,23,45,448,447,283,282,1253,731,729,126784,46339552.0,126054,133224.75
528,65,54,15,34,145,144,127,126,102,272,270,18415,2504440.0,18144,18360.0
5280,29,27,11,13,124,123,81,80,40,205,203,10044,1029510.0,9840,10403.75
5281,26,21,7,13,140,139,146,145,151,286,284,20440,2922920.0,20155,20306.0
5282,41,34,12,24,128,127,230,229,276,358,356,29440,5269760.0,29083,31862.0
5283,73,64,27,43,210,209,346,345,732,556,554,72660,20199480.0,72105,77006.0
5284,71,61,19,37,170,169,171,170,148,341,339,29070,4956435.0,28730,28899.75
5285,86,69,22,52,169,168,153,152,171,322,320,25857,4162977.0,25536,25760.0
5286,105,101,10,16,124,123,178,177,116,302,300,22072,3332872.0,21771,22650.0
5287,30,25,10,18,97,96,105,104,40,202,200,10185,1028685.0,9984,10100.0
5288,51,35,13,40,146,145,119,118,95,265,263,17374,2302055.0,17110,17423.75
5289,28,27,9,9,284,283,135,134,278,419,417,38340,8032230.0,37922,43680.75
529,51,38,21,45,226,225,168,167,208,394,392,37968,7479696.0,37575,38612.0
5290,50,43,15,25,272,271,145,144,294,417,415,39440,8223240.0,39024,43263.75
5291,46,36,17,34,152,151,116,115,112,268,266,17632,2362688.0,17365,17822.0
5292,78,66,25,47,215,214,249,248,401,464,462,53535,12420120.0,53072,53592.0
5293,81,73,21,35,165,164,186,185,166,351,349,30690,5386095.0,30340,30624.75
5294,66,46,20,58,188,187,126,125,132,314,312,23688,3719016.0,23375,24492.0
5295,61,48,21,45,161,160,147,146,158,308,306,23667,3644718.0,23360,23562.0
5296,65,55,22,40,150,149,158,157,148,308,306,23700,3649800.0,23393,23562.0
5297,95,78,37,69,224,223,312,311,537,536,534,69888,18729984.0,69353,71556.0
5298,50,42,13,25,123,122,193,192,187,316,314,23739,3750762.0,23424,24806.0
5299,71,60,26,46,180,179,297,296,359,477,475,53460,12750210.0,52984,56643.75
53,79,70,16,31,117,116,173,172,126,290,288,20241,2934945.0,19952,20880.0
530,39,33,15,22,117,116,186,185,122,303,301,21762,3296943.0,21460,22800.75
5300,46,40,13,22,138,137,100,99,71,238,236,13800,1642200.0,13563,14042.0
5301,72,61,24,44,401,400,317,316,1568,718,716,127117,45635003.0,126400,128522.0
5302,97,72,30,77,318,317,409,408,1247,727,725,130062,47277537.0,129336,131768.75
5303,130,110,33,68,308,307,314,313,1133,622,620,96712,30077432.0,96091,96410.0
5304,58,44,21,47,166,165,141,140,177,307,305,23406,3592821.0,23100,23408.75
5305,45,38,13,25,165,164,122,121,103,287,285,20130,2888655.0,19844,20448.75
5306,51,43,19,33,301,300,216,215,475,517,515,65016,16806636.0,64500,66563.75
5307,48,42,12,20,148,147,129,128,106,277,275,19092,2644242.0,18816,19043.75
5308,33,31,12,14,225,224,161,160,233,386,384,36225,6991425.0,35840,37056.0
5309,93,78,37,64,264,263,258,257,531,522,520,68112,17777232.0,67591,67860.0
531,32,27,10,17,217,216,157,156,220,374,372,34069,6370903.0,33696,34782.0
5310,66,52,24,50,168,167,180,179,165,348,346,30240,5261760.0,29893,30102.0
5311,73,67,8,14,186,185,138,137,145,324,322,25668,4158216.0,25345,26082.0
5312,97,74,28,66,253,252,237,236,523,490,488,59961,14690445.0,59472,59780.0
5313,69,63,21,29,129,128,130,129,131,259,257,16770,2171715.0,16512,16640.75
5314,81,77,18,24,230,229,303,302,496,533,531,69690,18572385.0,69158,70755.75
5315,45,33,16,37,192,191,151,150,197,343,341,28992,4972128.0,28650,29240.75
5316,25,20,7,12,155,154,97,96,97,252,250,15035,1894410.0,14784,15750.0
5317,72,62,20,38,149,148,155,154,192,304,302,23095,3510440.0,22792,22952.0
5318,57,53,14,20,138,137,114,113,113,252,250,15732,1982232.0,15481,15750.0
5319,33,28,10,15,103,102,99,98,53,202,200,10197,1029897.0,9996,10100.0
532,53,49,13,17,138,137,165,164,144,303,301,22770,3449655.0,22468,22800.75
5320,40,34,14,22,146,145,96,95,78,242,240,14016,1695936.0,13775,14520.0
5321,62,46,17,47,114,113,115,114,98,229,227,13110,1501095.0,12882,12995.75
5322,40,31,10,21,246,245,164,163,412,410,408,40344,8270520.0,39935,41820.0
5323,40,34,11,21,95,94,162,161,102,257,255,15390,1977615.0,15134,16383.75
5324,80,68,16,37,151,150,226,225,352,377,375,34126,6432751.0,33750,35343.75
5325,35,31,11,17,95,94,131,130,47,226,224,12445,1406285.0,12220,12656.0
5326,137,110,32,82,365,364,267,266,975,632,630,97455,30795780.0,96824,99540.0
5327,33,28,12,18,260,259,151,150,275,411,409,39260,8067930.0,38850,42024.75
5328,32,27,9,14,223,222,150,149,222,373,371,33450,6238425.0,33078,34595.75
5329,32,23,12,23,152,151,96,95,82,248,246,14592,1809408.0,14345,15252.0
533,66,55,22,42,185,184,273,272,376,458,456,50505,11565645.0,50048,52212.0
5330,42,38,11,16,114,113,119,118,49,233,231,13566,1580439.0,13334,13455.75
5331,49,42,18,27,144,143,173,172,179,317,315,24912,3948552.0,24596,24963.75
5332,40,29,11,31,137,136,214,213,227,351,349,29318,5145309.0,28968,30624.75
5333,50,47,13,17,95,94,111,110,38,206,204,10545,1086135.0,10340,10506.0
5334,46,37,11,26,128,127,127,126,80,255,253,16256,2072640.0,16002,16128.75
5335,63,52,17,35,153,152,178,177,187,331,329,27234,4507227.0,26904,27224.75
5336,72,58,21,47,160,159,165,164,166,325,323,26400,4290000.0,26076,26243.75
5337,97,81,24,54,218,217,218,217,288,436,434,47524,10360232.0,47089,47306.0
5338,43,36,12,22,144,143,129,128,120,273,271,18576,2535624.0,18304,18495.75
5339,52,46,12,21,112,111,156,155,82,268,266,17472,2341248.0,17205,17822.0
534,119,104,41,68,383,382,263,262,976,646,644,100729,32535467.0,100084,104006.0
5340,47,37,14,32,116,115,98,97,62,214,212,11368,1216376.0,11155,11342.0
5341,42,33,14,26,88,87,83,82,38,171,169,7304,624492.0,7134,7224.75
5342,85,71,26,52,207,206,267,266,610,474,472,55269,13098753.0,54796,55932.0
5343,43,37,13,20,109,108,177,176,106,286,284,19293,2758899.0,19008,20306.0
5344,69,63,17,27,156,155,127,126,117,283,281,19812,2803398.0,19530,19880.75
5345,47,36,11,31,153,152,162,161,176,315,313,24786,3903795.0,24472,24648.75
5346,88,76,19,41,237,236,242,241,370,479,477,57354,13736283.0,56876,57120.75
5347,25,20,7,13,147,146,141,140,157,288,286,20727,2984688.0,20440,20592.0
5348,34,30,11,16,157,156,117,116,128,274,272,18369,2516553.0,18096,18632.0
5349,21,16,5,12,117,116,132,131,98,249,247,15444,1922778.0,15196,15375.75
535,48,37,17,37,136,135,146,145,131,282,280,19856,2799696.0,19575,19740.0
5350,111,94,31,63,225,224,271,270,468,496,494,60975,15121800.0,60480,61256.0
5351,71,64,21,33,176,175,146,145,205,322,320,25696,4137056.0,25375,25760.0
5352,59,45,21,47,254,253,151,150,257,405,403,38354,7766685.0,37950,40803.75
5353,121,105,32,60,356,355,325,324,2313,681,679,115700,39395850.0,115020,115599.75
5354,109,104,10,17,178,177,262,261,430,440,438,46636,10259920.0,46197,48180.0
5355,75,60,24,51,161,160,151,150,138,312,310,24311,3792516.0,24000,24180.0
5356,67,59,18,32,132,131,92,91,44,224,222,12144,1360128.0,11921,12432.0
5358,34,23,9,21,93,92,73,72,32,166,164,6789,563487.0,6624,6806.0
5359,45,36,16,31,173,172,144,143,127,317,315,24912,3948552.0,24596,24963.75
536,52,44,14,27,103,102,237,236,183,340,338,24411,4149870.0,24072,28730.0
5361,64,61,13,17,110,109,127,126,64,237,235,13970,1655445.0,13734,13923.75
5362,84,69,29,53,172,171,211,210,196,383,381,36292,6949918.0,35910,36480.75
5363,65,50,17,44,118,117,117,116,76,235,233,13806,1622205.0,13572,13688.75
5364,103,87,31,59,209,208,325,324,709,534,532,67925,18135975.0,67392,71022.0
5365,58,48,22,39,257,256,355,354,988,612,610,91235,27917910.0,90624,93330.0
5366,83,69,27,53,271,270,152,151,303,423,421,41192,8712108.0,40770,44520.75
5367,39,30,11,26,88,87,147,146,92,235,233,12936,1519980.0,12702,13688.75
5368,87,75,23,45,280,279,186,185,306,466,464,52080,12134640.0,51615,54056.0
5369,57,45,10,26,198,197,156,155,206,354,352,30888,5467176.0,30535,31152.0
537,55,43,18,38,178,177,139,138,186,317,315,24742,3921607.0,24426,24963.75
5370,99,83,27,55,205,204,339,338,744,544,542,69495,18902640.0,68952,73712.0
5371,46,43,11,15,131,130,120,119,92,251,249,15720,1972860.0,15470,15624.75
5372,52,41,14,29,201,200,128,127,147,329,327,25728,4232256.0,25400,26895.75
5373,140,139,7,7,147,146,147,146,122,294,292,21609,3176523.0,21316,21462.0
5374,52,39,15,37,121,120,100,99,67,221,219,12100,1337050.0,11880,12099.75
5376,118,100,35,67,402,401,397,396,1553,799,797,159594,63757803.0,158796,159200.75
5377,39,31,10,20,229,228,136,135,277,365,363,31144,5683780.0,30780,33123.75
5378,45,37,15,27,103,102,100,99,52,203,201,10300,1045450.0,10098,10200.75
5379,40,36,8,13,114,113,74,73,32,188,186,8436,792984.0,8249,8742.0
538,29,27,7,9,108,107,376,375,305,484,482,40608,9827136.0,40125,58322.0
5380,25,23,8,10,214,213,142,141,164,356,354,30388,5409064.0,30033,31506.0
5381,83,67,22,52,423,422,349,348,2023,772,770,147627,56984022.0,146856,148610.0
5382,65,53,18,39,134,133,165,164,120,299,297,22110,3305445.0,21812,22200.75
5383,45,38,16,27,122,121,181,180,134,303,301,22082,3345423.0,21780,22800.75
5384,83,72,28,48,327,326,323,322,972,650,648,105621,34326825.0,104972,105300.0
5385,73,62,22,42,137,136,202,201,174,339,337,27674,4690743.0,27336,28560.75
5386,70,60,25,43,191,190,267,266,404,458,456,50997,11678313.0,50540,52212.0
5387,58,49,17,31,188,187,154,153,156,342,340,28952,4950792.0,28611,29070.0
5388,60,49,24,44,245,244,189,188,402,434,432,46305,10048185.0,45872,46872.0
5389,57,47,18,34,280,279,213,212,758,493,491,59640,14701260.0,59148,60515.75
539,47,36,12,32,87,86,135,134,68,222,220,11745,1303695.0,11524,12210.0
5390,80,64,29,59,224,223,314,313,771,538,536,70336,18920384.0,69799,72092.0
5391,80,71,28,44,241,240,200,199,322,441,439,48200,10628100.0,47760,48399.75
5392,50,40,15,33,211,210,124,123,137,335,333,26164,4382470.0,25830,27888.75
5393,41,35,13,22,298,297,232,231,731,530,528,69136,18321040.0,68607,69960.0
5394,61,46,20,45,142,141,129,128,128,271,269,18318,2482089.0,18048,18224.75
5395,43,39,10,16,103,102,116,115,51,219,217,11948,1308306.0,11730,11880.75
5396,168,148,47,85,536,535,319,318,2692,855,853,170984,73095660.0,170130,182328.75
5397,62,48,17,35,186,185,223,222,301,409,407,41478,8482251.0,41070,41615.75
5398,44,40,14,18,132,131,147,146,110,279,277,19404,2706858.0,19126,19320.75
5399,43,35,17,31,119,118,106,105,59,225,223,12614,1419075.0,12390,12543.75
54,51,42,14,30,145,144,149,148,205,294,292,21605,3175935.0,21312,21462.0
540,31,26,13,21,139,138,97,96,56,236,234,13483,1590994.0,13248,13806.0
5400,83,68,25,51,242,241,134,133,204,376,374,32428,6096464.0,32053,35156.0
5401,78,63,23,50,269,268,144,143,287,413,411,38736,7998984.0,38324,42435.75
5402,29,27,8,10,251,250,211,210,509,462,460,52961,12233991.0,52500,53130.0
5403,54,46,18,32,155,154,120,119,109,275,273,18600,2557500.0,18326,18768.75
5404,77,63,26,51,228,227,300,299,692,528,526,68400,18057600.0,67873,69432.0
5405,63,50,21,44,178,177,144,143,202,322,320,25632,4126752.0,25311,25760.0
5406,72,60,23,45,322,321,179,178,502,501,499,57638,14438319.0,57138,62499.75
5407,97,86,22,41,162,161,200,199,212,362,360,32400,5864400.0,32039,32580.0
5408,27,22,10,18,153,152,172,171,197,325,323,26316,4276350.0,25992,26243.75
5409,56,42,18,43,172,171,124,123,119,296,294,21328,3156544.0,21033,21756.0
541,51,40,16,30,196,195,256,255,494,452,450,50176,11339776.0,49725,50850.0
5410,39,34,12,20,161,160,120,119,186,281,279,19320,2714460.0,19040,19599.75
5411,105,101,10,16,124,123,178,177,120,302,300,22072,3332872.0,21771,22650.0
5412,49,35,14,37,157,156,304,303,500,461,459,47728,11001304.0,47268,52899.75
5413,48,43,19,26,159,158,146,145,137,305,303,23214,3540135.0,22910,23103.75
5414,60,50,23,37,184,183,162,161,207,346,344,29808,5156784.0,29463,29756.0
5415,59,57,9,11,124,123,146,145,103,270,268,18104,2444040.0,17835,18090.0
5416,51,40,17,35,155,154,203,202,260,358,356,31465,5632235.0,31108,31862.0
5417,69,55,19,43,232,231,159,158,254,391,389,36888,7211604.0,36498,38024.75
5418,137,118,33,69,248,247,220,219,448,468,466,54560,12767040.0,54093,54522.0
5419,45,36,15,30,180,179,151,150,177,331,329,27180,4498290.0,26850,27224.75
542,72,64,18,30,147,146,173,172,182,320,318,25431,4068960.0,25112,25440.0
5420,65,53,22,44,153,152,148,147,144,301,299,22644,3407922.0,22344,22499.75
5421,60,56,13,17,104,103,145,144,66,249,247,15080,1877460.0,14832,15375.75
5422,68,63,15,23,119,118,149,148,98,268,266,17731,2375954.0,17464,17822.0
5423,70,64,22,32,198,197,127,126,204,325,323,25146,4086225.0,24822,26243.75
5424,81,66,29,52,208,207,263,262,405,471,469,54704,12882792.0,54234,55224.75
5425,48,43,17,25,111,110,132,131,76,243,241,14652,1780218.0,14410,14640.75
5426,78,66,31,50,235,234,393,392,704,628,626,92355,28999470.0,91728,98282.0
5427,46,39,16,28,136,135,210,209,155,346,344,28560,4940880.0,28215,29756.0
5428,60,49,18,37,155,154,144,143,127,299,297,22320,3336840.0,22022,22200.75
5429,76,71,19,26,102,101,145,144,90,247,245,14790,1826565.0,14544,15128.75
543,60,50,20,36,252,251,215,214,419,467,465,54180,12651030.0,53714,54288.75
5430,74,57,27,58,491,490,316,315,2114,807,805,155156,62605446.0,154350,162408.75
5431,62,58,17,22,111,110,116,115,54,227,225,12876,1461426.0,12650,12768.75
5432,50,42,15,29,349,348,194,193,480,543,541,67706,18382179.0,67164,73440.75
5433,71,54,20,51,187,186,172,171,292,359,357,32164,5773438.0,31806,32040.75
5434,49,40,14,29,120,119,184,183,97,304,302,22080,3356160.0,21777,22952.0
5435,65,54,13,31,114,113,109,108,62,223,221,12426,1385499.0,12204,12320.75
5436,45,39,11,19,197,196,102,101,84,299,297,20094,3004053.0,19796,22200.75
5437,44,30,13,37,207,206,218,217,352,425,423,45126,9589275.0,44702,44943.75
5438,117,96,31,71,446,445,387,386,2190,833,831,172602,71888733.0,171770,173055.75
5439,32,24,9,17,154,153,126,125,123,280,278,19404,2716560.0,19125,19460.0
544,30,26,6,9,110,109,105,104,54,215,213,11550,1241625.0,11336,11448.75
5440,21,19,6,8,154,153,75,74,59,229,227,11550,1322475.0,11322,12995.75
5441,74,66,31,45,379,378,422,421,2628,801,799,159938,64055169.0,159138,159999.75
5442,42,34,11,24,127,126,144,143,95,271,269,18288,2478024.0,18018,18224.75
5443,86,71,25,52,165,164,274,273,336,439,437,45210,9923595.0,44772,47960.75
5444,66,60,14,23,145,144,107,106,103,252,250,15515,1954890.0,15264,15750.0
5445,47,38,10,25,115,114,134,133,89,249,247,15410,1918545.0,15162,15375.75
5446,59,48,23,41,139,138,165,164,122,304,302,22935,3486120.0,22632,22952.0
5447,103,85,29,62,193,192,171,170,265,364,362,33003,6006546.0,32640,32942.0
5448,90,76,25,50,310,309,267,266,918,577,575,82770,23879145.0,82194,82943.75
5449,119,114,12,20,178,177,147,146,191,325,323,26166,4251975.0,25842,26243.75
545,55,41,20,43,147,146,240,239,308,387,385,35280,6826680.0,34894,37248.75
5450,77,65,24,45,147,146,200,199,227,347,345,29400,5100900.0,29054,29928.75
5451,97,88,18,34,157,156,153,152,189,310,308,24021,3723255.0,23712,23870.0
5452,56,44,12,33,123,122,134,133,103,257,255,16482,2117937.0,16226,16383.75
5453,57,51,16,24,130,129,185,184,167,315,313,24050,3787875.0,23736,24648.75
5454,34,30,8,12,201,200,170,169,222,371,369,34170,6338535.0,33800,34224.75
5455,86,73,29,50,231,230,176,175,304,407,405,40656,8273496.0,40250,41208.75
5456,20,18,6,8,119,118,93,92,48,212,210,11067,1173102.0,10856,11130.0
5457,47,38,14,29,183,182,115,114,178,298,296,21045,3135705.0,20748,22052.0
5458,70,55,25,53,203,202,259,258,437,462,460,52577,12145287.0,52116,53130.0
5459,73,64,26,42,174,173,141,140,131,315,313,24534,3864105.0,24220,24648.75
546,53,44,16,29,138,137,127,126,119,265,263,17526,2322195.0,17262,17423.75
5461,34,24,8,18,183,182,150,149,223,333,331,27450,4570425.0,27118,27555.75
5462,50,32,16,48,126,125,219,218,189,345,343,27594,4759965.0,27250,29583.75
5464,20,19,5,5,115,114,167,166,96,282,280,19205,2707905.0,18924,19740.0
5465,75,64,19,38,150,149,228,227,259,378,376,34200,6463800.0,33823,35532.0
5466,52,41,17,37,139,138,204,203,202,343,341,28356,4863054.0,28014,29240.75
5467,59,52,14,24,97,96,220,219,127,317,315,21340,3382390.0,21024,24963.75
5468,42,33,13,29,109,108,103,102,77,212,210,11227,1190062.0,11016,11130.0
5469,59,49,12,29,104,103,120,119,86,224,222,12480,1397760.0,12257,12432.0
5470,67,62,23,31,185,184,146,145,185,331,329,27010,4470155.0,26680,27224.75
5471,63,54,24,40,162,161,208,207,235,370,368,33696,6233760.0,33327,34040.0
5472,138,118,42,78,323,322,298,297,1673,621,619,96254,29886867.0,95634,96099.75
5473,110,99,24,44,195,194,183,182,222,378,376,35685,6744465.0,35308,35532.0
5474,87,66,31,71,233,232,154,153,236,387,385,35882,6943167.0,35496,37248.75
5475,63,53,19,37,161,160,123,122,122,284,282,19803,2812026.0,19520,20022.0
5476,94,81,20,44,134,133,172,171,170,306,304,23048,3526344.0,22743,23256.0
5477,70,58,17,37,158,157,237,236,353,395,393,37446,7395585.0,37052,38808.75
5478,70,59,15,31,113,112,213,212,152,326,324,24069,3923247.0,23744,26406.0
5479,55,50,13,21,93,92,182,181,83,275,273,16926,2327325.0,16652,18768.75
548,76,70,25,33,195,194,141,140,242,336,334,27495,4619160.0,27160,28056.0
5480,124,106,15,46,248,247,159,158,330,407,405,39432,8024412.0,39026,41208.75
5481,35,30,12,17,85,84,146,145,55,231,229,12410,1433355.0,12180,13224.75
5482,83,68,27,53,277,276,208,207,443,485,483,57616,13971880.0,57132,58563.75
5483,29,24,8,16,283,282,189,188,399,472,470,53487,12622932.0,53016,55460.0
5484,75,62,24,48,175,174,120,119,132,295,293,21000,3097500.0,20706,21608.75
5485,36,30,12,22,144,143,156,155,107,300,298,22464,3369600.0,22165,22350.0
5486,53,46,21,31,167,166,167,166,187,334,332,27889,4657463.0,27556,27722.0
5487,59,42,20,52,155,154,124,123,142,279,277,19220,2681190.0,18942,19320.75
5488,60,53,15,27,160,159,119,118,94,279,277,19040,2656080.0,18762,19320.75
5489,133,109,45,91,416,415,344,343,1785,760,758,143104,54379520.0,142345,144020.0
549,96,79,27,59,277,276,182,181,348,459,457,50414,11570013.0,49956,52440.75
5490,58,53,16,24,171,170,130,129,139,301,299,22230,3345615.0,21930,22499.75
5491,98,86,18,40,138,137,185,184,181,323,321,25530,4123095.0,25208,25920.75
5492,53,51,12,14,154,153,152,151,143,306,304,23408,3581424.0,23103,23256.0
5493,118,117,7,7,193,192,124,123,140,317,315,23932,3793222.0,23616,24963.75
5494,106,82,37,82,456,455,362,361,2464,818,816,165072,67514448.0,164255,166872.0
5495,110,100,27,45,199,198,142,141,230,341,339,28258,4817989.0,27918,28899.75
5496,90,73,32,64,278,277,320,319,953,598,596,88960,26599040.0,88363,89102.0
5497,163,138,48,95,464,463,414,413,1943,878,876,192096,84330144.0,191219,192282.0
5498,63,54,19,35,322,321,322,321,816,644,642,103684,33386248.0,103041,103362.0
5499,51,41,19,37,208,207,127,126,169,335,333,26416,4424680.0,26082,27888.75
55,53,46,20,31,162,161,175,174,161,337,335,28350,4776975.0,28014,28223.75
550,54,44,14,30,163,162,123,122,125,286,284,20049,2867007.0,19764,20306.0
5500,117,96,34,73,412,411,434,433,2983,846,844,178808,75635784.0,177963,178506.0
5501,50,46,15,21,170,169,186,185,184,356,354,31620,5628360.0,31265,31506.0
5502,99,90,32,48,434,433,296,295,1078,730,728,128464,46889360.0,127735,132860.0
5503,44,30,10,34,130,129,117,116,88,247,245,15210,1878435.0,14964,15128.75
5504,40,33,14,24,128,127,183,182,162,311,309,23424,3642432.0,23114,24024.75
5505,48,36,15,37,226,225,201,200,360,427,425,45426,9698451.0,45000,45368.75
5506,41,33,15,29,150,149,222,221,216,372,370,33300,6193800.0,32929,34410.0
5507,102,87,23,51,158,157,218,217,222,376,374,34444,6475472.0,34069,35156.0
5508,72,63,17,33,132,131,237,236,251,369,367,31284,5771898.0,30916,33855.75
5509,35,27,11,24,223,222,101,100,184,324,322,22523,3648726.0,22200,26082.0
551,98,96,15,17,151,150,231,230,289,382,380,34881,6662271.0,34500,36290.0
5510,67,54,20,44,231,230,131,130,224,362,360,30261,5477241.0,29900,32580.0
5511,47,39,13,23,112,111,154,153,101,266,264,17248,2293984.0,16983,17556.0
5512,41,38,13,16,156,155,181,180,156,337,335,28236,4757766.0,27900,28223.75
5513,72,63,23,34,141,140,233,232,273,374,372,32853,6143511.0,32480,34782.0
5514,72,59,30,52,282,281,132,131,235,414,412,37224,7705368.0,36811,42642.0
5515,52,45,18,30,170,169,145,144,128,315,313,24650,3882375.0,24336,24648.75
5516,80,71,16,32,147,146,128,127,116,275,273,18816,2587200.0,18542,18768.75
5517,84,76,21,34,209,208,169,168,193,378,376,35321,6675669.0,34944,35532.0
5518,70,53,27,57,255,254,404,403,1133,659,657,103020,33945090.0,102362,108240.75
5519,78,69,25,40,214,213,219,218,329,433,431,46866,10146489.0,46434,46655.75
552,53,46,19,29,142,141,127,126,105,269,267,18034,2425573.0,17766,17955.75
5520,54,46,15,25,202,201,350,349,490,552,550,70700,19513200.0,70149,75900.0
5521,78,61,24,54,128,127,226,225,250,354,352,28928,5120256.0,28575,31152.0
5522,64,51,17,34,195,194,157,156,235,352,350,30615,5388240.0,30264,30800.0
5523,38,27,11,31,127,126,97,96,67,224,222,12319,1379728.0,12096,12432.0
5524,30,25,6,12,151,150,96,95,94,247,245,14496,1790256.0,14250,15128.75
5525,93,75,29,63,206,205,295,294,484,501,499,60770,15222885.0,60270,62499.75
5526,51,37,23,48,213,212,162,161,408,375,373,34506,6469875.0,34132,34968.75
5527,32,31,9,9,76,75,131,130,49,207,205,9956,1030446.0,9750,10608.75
5528,47,36,12,31,115,114,116,115,80,231,229,13340,1540770.0,13110,13224.75
5529,154,153,9,9,170,169,170,169,241,340,338,28900,4913000.0,28561,28730.0
553,95,75,34,72,299,298,354,353,1272,653,651,105846,34558719.0,105194,106275.75
5530,69,50,21,55,242,241,329,328,731,571,569,79618,22730939.0,79048,81224.75
5531,106,86,26,60,275,274,158,157,326,433,431,43450,9406925.0,43018,46655.75
5532,46,37,17,31,106,105,171,170,101,277,275,18126,2510451.0,17850,19043.75
5533,100,80,32,69,226,225,194,193,309,420,418,43844,9207240.0,43425,43890.0
5534,46,38,14,27,153,152,136,135,119,289,287,20808,3006756.0,20520,20735.75
5535,56,47,19,34,163,162,111,110,118,274,272,18093,2478741.0,17820,18632.0
5536,122,117,14,22,147,146,178,177,174,325,323,26166,4251975.0,25842,26243.75
5537,25,23,7,9,154,153,111,110,78,265,263,17094,2264955.0,16830,17423.75
5538,64,47,16,45,140,139,190,189,182,330,328,26600,4389000.0,26271,27060.0
554,65,47,19,48,282,281,260,259,835,542,540,73320,19869720.0,72779,73170.0
5540,59,50,17,32,134,133,178,177,145,312,310,23852,3720912.0,23541,24180.0
5541,89,76,31,55,261,260,198,197,359,459,457,51678,11860101.0,51220,52440.75
5542,65,57,21,33,148,147,208,207,210,356,354,30784,5479552.0,30429,31506.0
5543,105,87,30,57,213,212,242,241,378,455,453,51546,11726715.0,51092,51528.75
5544,56,44,20,41,197,196,212,211,277,409,407,41764,8540738.0,41356,41615.75
5545,95,77,26,60,185,184,257,256,500,442,440,47545,10507445.0,47104,48620.0
5547,48,39,13,29,198,197,372,371,887,570,568,73656,20991960.0,73087,80940.0
5548,31,26,9,16,132,131,200,199,138,332,330,26400,4382400.0,26069,27390.0
5549,50,39,13,29,148,147,110,109,94,258,256,16280,2100120.0,16023,16512.0
555,73,67,15,24,178,177,101,100,125,279,277,17978,2507931.0,17700,19320.75
5550,36,25,10,25,129,128,103,102,67,232,230,13287,1541292.0,13056,13340.0
5551,43,37,11,21,179,178,110,109,118,289,287,19690,2845205.0,19402,20735.75
5552,49,35,14,40,120,119,96,95,83,216,214,11520,1244160.0,11305,11556.0
5554,26,24,6,8,103,102,104,103,54,207,205,10712,1108692.0,10506,10608.75
5555,107,102,10,18,178,177,124,123,118,302,300,22072,3332872.0,21771,22650.0
5556,35,29,12,22,125,124,211,210,166,336,334,26375,4431000.0,26040,28056.0
5557,85,74,21,36,196,195,220,219,280,416,414,43120,8968960.0,42705,43056.0
5559,112,96,28,56,245,244,193,192,293,438,436,47285,10355415.0,46848,47742.0
556,36,30,11,21,139,138,103,102,80,242,240,14317,1732357.0,14076,14520.0
5560,82,76,19,29,145,144,195,194,153,340,338,28275,4806750.0,27936,28730.0
5561,71,57,24,50,292,291,154,153,389,446,444,44968,10027864.0,44523,49506.0
5562,86,77,17,33,114,113,178,177,97,292,290,20292,2962632.0,20001,21170.0
5563,76,59,29,60,175,174,238,237,277,413,411,41650,8600725.0,41238,42435.75
5565,51,42,19,34,291,290,141,140,352,432,430,41031,8862696.0,40600,46440.0
5566,49,38,16,36,149,148,119,118,108,268,266,17731,2375954.0,17464,17822.0
5567,331,279,47,145,469,468,509,508,12463,978,976,238721,116734569.0,237744,238632.0
5568,59,48,13,32,165,164,144,143,192,309,307,23760,3670920.0,23452,23715.75
5569,33,29,12,17,139,138,135,134,76,274,272,18765,2570805.0,18492,18632.0
557,37,33,11,16,81,80,154,153,86,235,233,12474,1465695.0,12240,13688.75
5570,68,58,19,37,178,177,128,127,164,306,304,22784,3485952.0,22479,23256.0
5571,62,51,21,41,341,340,493,492,2042,834,832,168113,70103121.0,167280,173472.0
5572,98,82,22,51,195,194,221,220,284,416,414,43095,8963760.0,42680,43056.0
5574,42,40,13,15,126,125,190,189,138,316,314,23940,3782520.0,23625,24806.0
5575,36,30,14,24,83,82,184,183,86,267,265,15272,2038812.0,15006,17688.75
5576,70,64,16,26,147,146,147,146,124,294,292,21609,3176523.0,21316,21462.0
5577,35,33,14,16,180,179,82,81,83,262,260,14760,1933560.0,14499,17030.0
5578,43,38,13,21,138,137,117,116,92,255,253,16146,2058615.0,15892,16128.75
5579,35,29,9,17,133,132,95,94,107,228,226,12635,1440390.0,12408,12882.0
558,78,64,21,47,187,186,231,230,272,418,416,43197,9028173.0,42780,43472.0
5580,76,63,27,51,268,267,155,154,360,423,421,41540,8785710.0,41118,44520.75
5581,59,51,17,27,205,204,128,127,180,333,331,26240,4368960.0,25908,27555.75
5582,78,68,21,37,279,278,257,256,536,536,534,71703,19216404.0,71168,71556.0
5583,59,51,15,24,136,135,101,100,73,237,235,13736,1627716.0,13500,13923.75
5584,35,32,15,18,208,207,291,290,457,499,497,60528,15101736.0,60030,62000.75
5585,51,40,20,39,185,184,214,213,296,399,397,39590,7898205.0,39192,39600.75
5586,65,58,16,27,136,135,229,228,232,365,363,31144,5683780.0,30780,33123.75
5587,79,67,22,44,225,224,222,221,389,447,445,49950,11163825.0,49504,49728.75
5589,66,53,25,49,154,153,160,159,158,314,312,24640,3868480.0,24327,24492.0
559,30,24,10,17,91,90,79,78,31,170,168,7189,611065.0,7020,7140.0
5590,81,66,25,52,278,277,208,207,315,486,484,57824,14051232.0,57339,58806.0
5591,79,62,27,59,205,204,371,370,923,576,574,76055,21903840.0,75480,82656.0
5592,94,82,25,47,241,240,240,239,512,481,479,57840,13910520.0,57360,57599.75
5593,73,62,19,39,236,235,143,142,212,379,377,33748,6395246.0,33370,35720.75
5594,43,34,12,21,103,102,114,113,75,217,215,11742,1274007.0,11526,11663.75
5595,51,48,14,17,252,251,131,130,266,383,381,33012,6321798.0,32630,36480.75
5596,40,33,16,24,229,228,226,225,584,455,453,51754,11774035.0,51300,51528.75
5597,45,41,12,17,99,98,99,98,65,198,196,9801,970299.0,9604,9702.0
5598,19,16,2,4,145,144,109,108,91,254,252,15805,2007235.0,15552,16002.0
5599,47,35,14,26,166,165,115,114,144,281,279,19090,2682145.0,18810,19599.75
56,45,34,18,36,220,219,289,288,606,509,507,63580,16181110.0,63072,64515.75
560,57,43,18,39,180,179,126,125,129,306,304,22680,3470040.0,22375,23256.0
5600,200,167,56,120,465,464,375,374,2379,840,838,174375,73237500.0,173536,175980.0
5601,38,28,14,30,245,244,149,148,228,394,392,36505,7191485.0,36112,38612.0
5602,57,53,12,16,185,184,194,193,312,379,377,35890,6801155.0,35512,35720.75
5603,82,78,14,19,190,189,104,103,157,294,292,19760,2904720.0,19467,21462.0
5604,78,65,23,46,320,319,211,210,816,531,529,67520,17926560.0,66990,70224.75
5606,85,71,26,52,163,162,329,328,375,492,490,53627,13192242.0,53136,60270.0
5607,41,39,11,13,90,89,170,169,79,260,258,15300,1989000.0,15041,16770.0
5608,59,51,17,31,226,225,122,121,243,348,346,27572,4797528.0,27225,30102.0
5609,54,48,22,31,328,327,250,249,638,578,576,82000,23698000.0,81423,83232.0
561,43,32,12,28,126,125,101,100,70,227,225,12726,1444401.0,12500,12768.75
5610,90,73,31,61,363,362,318,317,1165,681,679,115434,39305277.0,114754,115599.75
5611,24,22,7,8,94,93,101,100,58,195,193,9494,925665.0,9300,9408.75
5612,35,25,7,17,159,158,175,174,191,334,332,27825,4646775.0,27492,27722.0
5613,35,32,14,17,151,150,113,112,106,264,262,17063,2252316.0,16800,17292.0
5614,73,57,22,51,215,214,319,318,815,534,532,68585,18312195.0,68052,71022.0
5615,36,33,14,18,266,265,173,172,319,439,437,46018,10100951.0,45580,47960.75
5616,69,65,17,23,97,96,131,130,65,228,226,12707,1448598.0,12480,12882.0
5617,66,52,17,43,193,192,289,288,523,482,480,55777,13442257.0,55296,57840.0
5618,20,18,7,9,117,116,133,132,121,250,248,15561,1945125.0,15312,15500.0
5619,47,41,13,23,198,197,151,150,167,349,347,29898,5217201.0,29550,30275.75
562,44,37,14,26,127,126,117,116,67,244,242,14859,1812798.0,14616,14762.0
5620,257,256,10,10,267,266,267,266,619,534,532,71289,19034163.0,70756,71022.0
5621,76,60,24,52,186,185,184,183,212,370,368,34224,6331440.0,33855,34040.0
5622,47,34,15,37,185,184,112,111,133,297,295,20720,3076920.0,20424,21903.75
5623,47,39,12,24,129,128,78,77,44,207,205,10062,1041417.0,9856,10608.75
5624,62,51,19,38,134,133,162,161,126,296,294,21708,3212784.0,21413,21756.0
5625,68,59,21,36,277,276,203,202,501,480,478,56231,13495440.0,55752,57360.0
5626,77,71,19,29,179,178,163,162,235,342,340,29177,4989267.0,28836,29070.0
5627,39,36,13,17,182,181,176,175,179,358,356,32032,5733728.0,31675,31862.0
5628,51,40,12,24,119,118,178,177,161,297,295,21182,3145527.0,20886,21903.75
5629,90,80,27,41,195,194,168,167,291,363,361,32760,5945940.0,32398,32760.75
563,96,89,30,42,237,236,145,144,203,382,380,34365,6563715.0,33984,36290.0
5630,53,42,14,34,109,108,70,69,35,179,177,7630,682885.0,7452,7920.75
5631,22,21,8,8,137,136,86,85,58,223,221,11782,1313693.0,11560,12320.75
5632,50,41,16,32,124,123,106,105,59,230,228,13144,1511560.0,12915,13110.0
5633,64,54,12,28,101,100,114,113,65,215,213,11514,1237755.0,11300,11448.75
5634,58,54,12,16,96,95,94,93,53,190,188,9024,857280.0,8835,8930.0
5635,39,30,15,31,156,155,152,151,130,308,306,23712,3651648.0,23405,23562.0
5636,74,69,18,26,133,132,117,116,88,250,248,15561,1945125.0,15312,15500.0
5637,137,109,34,88,489,488,374,373,3462,863,861,182886,78915309.0,182024,185760.75
5638,50,42,15,29,224,223,108,107,185,332,330,24192,4015872.0,23861,27390.0
5639,52,43,15,30,196,195,195,194,231,391,389,38220,7472010.0,37830,38024.75
564,51,37,18,42,217,216,143,142,253,360,358,31031,5585580.0,30672,32220.0
5640,19,18,6,6,153,152,138,137,119,291,289,21114,3072087.0,20824,21024.75
5641,64,49,17,44,205,204,133,132,240,338,336,27265,4607785.0,26928,28392.0
5642,58,49,16,30,109,108,94,93,53,203,201,10246,1039969.0,10044,10200.75
5643,42,36,11,21,110,109,200,199,117,310,308,22000,3410000.0,21691,23870.0
5644,29,26,12,16,97,96,146,145,75,243,241,14162,1720683.0,13920,14640.75
5645,26,23,8,12,306,305,80,79,142,386,384,24480,4724640.0,24095,37056.0
5646,58,46,20,38,118,117,192,191,129,310,308,22656,3511680.0,22347,23870.0
5647,109,93,29,59,228,227,207,206,324,435,433,47196,10265130.0,46762,47088.75
5648,65,58,17,29,110,109,181,180,138,291,289,19910,2896905.0,19620,21024.75
5649,71,62,21,36,197,196,148,147,164,345,343,29156,5029410.0,28812,29583.75
5650,75,57,28,56,220,219,169,168,294,389,387,37180,7231510.0,36792,37635.75
5651,55,45,14,30,97,96,117,116,61,214,212,11349,1214343.0,11136,11342.0
5652,47,40,14,25,263,262,178,177,464,441,439,46814,10322487.0,46374,48399.75
5653,65,53,15,34,128,127,162,161,126,290,288,20736,3006720.0,20447,20880.0
5654,82,68,28,54,225,224,204,203,239,429,427,45900,9845550.0,45472,45795.75
5655,73,59,27,52,403,402,187,186,563,590,588,75361,22231495.0,74772,86730.0
5656,63,56,17,26,210,209,197,196,329,407,405,41370,8418795.0,40964,41208.75
5657,82,67,20,48,178,177,179,178,192,357,355,31862,5687367.0,31506,31683.75
5658,52,39,12,36,156,155,101,100,75,257,255,15756,2024646.0,15500,16383.75
5659,27,18,7,20,120,119,92,91,73,212,210,11040,1170240.0,10829,11130.0
566,57,39,20,52,326,325,182,181,430,508,506,59332,15070328.0,58825,64262.0
5660,64,48,19,49,129,128,199,198,176,328,326,25671,4210044.0,25344,26732.0
5661,113,111,24,26,145,144,304,303,277,449,447,44080,9895960.0,43632,50175.75
5662,40,34,14,21,357,356,381,380,1413,738,736,136017,50190273.0,135280,135792.0
5663,75,65,15,33,121,120,144,143,90,265,263,17424,2308680.0,17160,17423.75
5664,78,67,20,40,148,147,252,251,264,400,398,37296,7459200.0,36897,39800.0
5665,52,39,11,35,142,141,161,160,140,303,301,22862,3463593.0,22560,22800.75
5666,39,34,11,18,138,137,134,133,146,272,270,18492,2514912.0,18221,18360.0
5667,91,72,35,70,504,503,476,475,5462,980,978,239904,117552960.0,238925,239610.0
5668,68,59,21,35,155,154,251,250,268,406,404,38905,7897715.0,38500,41006.0
5669,34,24,8,26,98,97,122,121,71,220,218,11956,1315160.0,11737,11990.0
567,67,57,20,38,288,287,231,230,612,519,517,66528,17264016.0,66010,67080.75
5670,65,52,24,48,276,275,229,228,348,505,503,63204,15959010.0,62700,63503.75
5671,39,33,13,23,95,94,93,92,37,188,186,8835,830490.0,8648,8742.0
5672,81,69,24,44,235,234,204,203,326,439,437,47940,10522830.0,47502,47960.75
5673,36,31,8,15,102,101,115,114,81,217,215,11730,1272705.0,11514,11663.75
5675,51,46,20,27,206,205,329,328,456,535,533,67774,18129545.0,67240,71288.75
5676,45,38,15,25,131,130,189,188,216,320,318,24759,3961440.0,24440,25440.0
5677,40,30,14,31,191,190,145,144,201,336,334,27695,4652760.0,27360,28056.0
5678,64,43,16,56,129,128,218,217,210,347,345,28122,4879167.0,27776,29928.75
5679,99,95,26,32,229,228,154,153,349,383,381,35266,6753439.0,34884,36480.75
568,21,20,4,4,116,115,185,184,125,301,299,21460,3229730.0,21160,22499.75
5680,63,54,11,27,148,147,271,270,243,419,417,40108,8402626.0,39690,43680.75
5681,60,48,14,35,184,183,146,145,178,330,328,26864,4432560.0,26535,27060.0
5682,56,54,16,18,244,243,248,247,629,492,490,60512,14885952.0,60021,60270.0
5683,54,52,9,11,103,102,77,76,32,180,178,7931,713790.0,7752,8010.0
5685,63,55,17,31,96,95,165,164,119,261,259,15840,2067120.0,15580,16899.75
5686,75,48,16,43,360,359,402,401,2065,762,760,144720,55138320.0,143959,144780.0
5687,70,64,11,21,118,117,228,227,187,346,344,26904,4654392.0,26559,29756.0
5688,57,53,13,19,197,196,93,92,92,290,288,18321,2656545.0,18032,20880.0
5689,37,33,12,18,148,147,248,247,227,396,394,36704,7267392.0,36309,39006.0
5690,52,40,17,38,203,202,231,230,376,434,432,46893,10175781.0,46460,46872.0
5691,87,80,26,35,498,497,330,329,3290,828,826,164340,68036760.0,163513,170982.0
5692,122,93,29,81,247,246,267,266,594,514,512,65949,16948893.0,65436,65792.0
5693,77,68,35,51,184,183,162,161,199,346,344,29808,5156784.0,29463,29756.0
5694,36,34,7,8,172,171,324,323,575,496,494,55728,13820544.0,55233,61256.0
5695,43,32,12,31,240,239,115,114,159,355,353,27600,4899000.0,27246,31328.75
5696,53,40,15,39,130,129,151,150,179,281,279,19630,2758015.0,19350,19599.75
5697,40,32,9,20,86,85,96,95,74,182,180,8256,751296.0,8075,8190.0
5698,34,28,8,17,121,120,120,119,78,241,239,14520,1749660.0,14280,14399.75
5699,35,31,11,17,288,287,156,155,339,444,442,44928,9974016.0,44485,49062.0
57,69,54,25,53,158,157,158,157,154,316,314,24964,3944312.0,24649,24806.0
570,64,49,19,47,222,221,138,137,235,360,358,30636,5514480.0,30277,32220.0
5700,90,73,29,60,440,439,266,265,1135,706,704,117040,41315120.0,116335,124256.0
5701,39,34,12,20,120,119,195,194,178,315,313,23400,3685500.0,23086,24648.75
5702,59,50,15,28,171,170,96,95,85,267,265,16416,2191536.0,16150,17688.75
5703,73,56,25,57,167,166,154,153,182,321,319,25718,4127739.0,25398,25599.75
5704,74,61,28,52,244,243,185,184,261,429,427,45140,9682530.0,44712,45795.75
5705,98,97,4,4,124,123,170,169,105,294,292,21080,3098760.0,20787,21462.0
5706,101,79,32,72,255,254,212,211,436,467,465,54060,12623010.0,53594,54288.75
5707,23,22,7,7,164,163,202,201,221,366,364,33128,6062424.0,32763,33306.0
5708,38,31,11,22,92,91,128,127,75,220,218,11776,1295360.0,11557,11990.0
5709,50,40,15,30,187,186,96,95,131,283,281,17952,2540208.0,17670,19880.75
571,39,36,10,12,95,94,83,82,31,178,176,7885,701765.0,7708,7832.0
5710,48,44,13,19,123,122,177,176,114,300,298,21771,3265650.0,21472,22350.0
5711,27,25,8,10,105,104,183,182,109,288,286,19215,2766960.0,18928,20592.0
5712,68,51,17,47,159,158,125,124,136,284,282,19875,2822250.0,19592,20022.0
5713,113,93,45,82,419,418,464,463,3647,883,881,194416,85834664.0,193534,194480.75
5714,73,64,17,33,141,140,247,246,198,388,386,34827,6756438.0,34440,37442.0
5715,63,35,11,65,281,280,183,182,645,464,462,51423,11930136.0,50960,53592.0
5716,67,56,20,38,208,207,353,352,817,561,559,73424,20595432.0,72864,78399.75
5717,45,35,15,32,199,198,186,185,313,385,383,37014,7125195.0,36630,36863.75
5718,40,36,12,18,103,102,217,216,166,320,318,22351,3576160.0,22032,25440.0
5719,55,44,21,41,128,127,146,145,134,274,272,18688,2560256.0,18415,18632.0
572,40,34,13,23,122,121,119,118,55,241,239,14518,1749419.0,14278,14399.75
5720,69,54,21,47,132,131,211,210,313,343,341,27852,4776618.0,27510,29240.75
5721,174,148,48,98,367,366,476,475,2386,843,841,174692,73632678.0,173850,177240.75
5722,166,142,55,101,392,391,384,383,2475,776,774,150528,58404864.0,149753,150156.0
5723,119,118,6,6,147,146,124,123,95,271,269,18228,2469894.0,17958,18224.75
5724,76,66,21,39,238,237,258,257,518,496,494,61404,15228192.0,60909,61256.0
5725,66,58,20,33,162,161,104,103,118,266,264,16848,2240784.0,16583,17556.0
5726,43,36,13,25,219,218,190,189,241,409,407,41610,8509245.0,41202,41615.75
5727,104,89,30,58,215,214,224,223,385,439,437,48160,10571120.0,47722,47960.75
5728,46,42,14,19,159,158,93,92,83,252,250,14787,1863162.0,14536,15750.0
5729,35,30,10,16,105,104,140,139,76,245,243,14700,1800750.0,14456,14883.75
573,35,28,10,22,143,142,76,75,79,219,217,10868,1190046.0,10650,11880.75
5730,39,33,11,20,113,112,207,206,211,320,318,23391,3742560.0,23072,25440.0
5731,50,41,14,29,141,140,128,127,162,269,267,18048,2427456.0,17780,17955.75
5732,73,63,15,33,112,111,149,148,86,261,259,16688,2177784.0,16428,16899.75
5733,20,19,4,4,164,163,91,90,89,255,253,14924,1902810.0,14670,16128.75
5734,50,41,16,31,113,112,242,241,183,355,353,27346,4853915.0,26992,31328.75
5735,164,140,60,106,533,532,476,475,5377,1009,1007,253708,127995686.0,252700,254015.75
5736,52,47,10,18,195,194,78,77,107,273,271,15210,2076165.0,14938,18495.75
5738,51,46,15,23,156,155,321,320,393,477,475,50076,11943126.0,49600,56643.75
5739,61,53,17,31,111,110,171,170,102,282,280,18981,2676321.0,18700,19740.0
574,38,34,12,16,157,156,131,130,100,288,286,20567,2961648.0,20280,20592.0
5740,30,23,12,21,138,137,137,136,106,275,273,18906,2599575.0,18632,18768.75
5741,90,71,22,58,221,220,181,180,360,402,400,40001,8040201.0,39600,40200.0
5742,69,56,12,36,95,94,95,94,47,190,188,9025,857375.0,8836,8930.0
5743,66,60,16,26,125,124,122,121,73,247,245,15250,1883375.0,15004,15128.75
5744,39,33,14,24,157,156,233,232,228,390,388,36581,7133295.0,36192,37830.0
5745,106,94,22,43,198,197,297,296,567,495,493,58806,14554485.0,58312,61008.75
5746,45,38,16,27,128,127,87,86,59,215,213,11136,1197120.0,10922,11448.75
5747,62,47,20,38,257,256,141,140,307,398,396,36237,7211163.0,35840,39402.0
5748,61,56,22,29,197,196,101,100,99,298,296,19897,2964653.0,19600,22052.0
5749,55,45,15,33,140,139,141,140,138,281,279,19740,2773470.0,19460,19599.75
575,47,38,16,28,125,124,125,124,81,250,248,15625,1953125.0,15376,15500.0
5750,32,30,9,11,113,112,191,190,120,304,302,21583,3280616.0,21280,22952.0
5751,40,37,14,18,112,111,112,111,62,224,222,12544,1404928.0,12321,12432.0
5753,34,29,9,15,212,211,228,227,242,440,438,48336,10633920.0,47897,48180.0
5754,399,388,14,34,506,505,447,446,7808,953,951,226182,107775723.0,225230,226575.75
5755,42,32,12,30,112,111,94,93,47,206,204,10528,1084384.0,10323,10506.0
5756,46,38,15,23,153,152,170,169,159,323,321,26010,4200615.0,25688,25920.75
5757,62,46,15,45,156,155,139,138,129,295,293,21684,3198390.0,21390,21608.75
5758,127,110,43,74,399,398,446,445,3596,845,843,177954,75185565.0,177110,178083.75
5759,54,45,15,31,210,209,129,128,172,339,337,27090,4591755.0,26752,28560.75
576,74,64,21,35,140,139,177,176,165,317,315,24780,3927630.0,24464,24963.75
5760,107,103,11,17,178,177,285,284,514,463,461,50730,11743995.0,50268,53360.75
5761,45,41,16,19,118,117,153,152,128,271,269,18054,2446317.0,17784,18224.75
5762,48,44,13,18,106,105,118,117,62,224,222,12508,1400896.0,12285,12432.0
5763,59,51,15,28,140,139,135,134,82,275,273,18900,2598750.0,18626,18768.75
5764,59,50,18,34,164,163,112,111,92,276,274,18368,2534784.0,18093,18906.0
5765,32,29,9,12,99,98,158,157,63,257,255,15642,2009997.0,15386,16383.75
5766,54,34,17,54,128,127,124,123,88,252,250,15872,1999872.0,15621,15750.0
5767,121,102,39,75,406,405,229,228,760,635,633,92974,29519245.0,92340,100488.75
5768,66,62,15,21,168,167,92,91,85,260,258,15456,2009280.0,15197,16770.0
5769,33,22,8,25,145,144,96,95,108,241,239,13920,1677360.0,13680,14399.75
577,55,49,19,26,246,245,259,258,506,505,503,63714,16087785.0,63210,63503.75
5770,73,59,23,48,168,167,189,188,250,357,355,31752,5667732.0,31396,31683.75
5771,91,61,33,90,368,367,398,397,1700,766,764,146464,56095712.0,145699,146306.0
5772,83,70,23,47,153,152,148,147,146,301,299,22644,3407922.0,22344,22499.75
5773,57,43,19,45,171,170,242,241,386,413,411,41382,8545383.0,40970,42435.75
5774,53,45,15,29,118,117,123,122,68,241,239,14514,1748937.0,14274,14399.75
5775,50,36,15,38,141,140,176,175,149,317,315,24816,3933336.0,24500,24963.75
5776,62,53,25,41,229,228,204,203,381,433,431,46716,10114014.0,46284,46655.75
5777,55,44,15,33,96,95,209,208,127,305,303,20064,3059760.0,19760,23103.75
5778,57,43,19,41,164,163,139,138,183,303,301,22796,3453594.0,22494,22800.75
5779,110,90,30,67,260,259,282,281,685,542,540,73320,19869720.0,72779,73170.0
5780,74,60,19,43,238,237,304,303,495,542,540,72352,19607392.0,71811,73170.0
5781,87,76,31,51,283,282,377,376,1070,660,658,106691,35208030.0,106032,108570.0
5782,257,256,10,10,267,266,267,266,595,534,532,71289,19034163.0,70756,71022.0
5784,61,47,20,43,149,148,145,144,125,294,292,21605,3175935.0,21312,21462.0
5785,48,40,14,25,139,138,141,140,97,280,278,19599,2743860.0,19320,19460.0
5786,52,50,13,15,105,104,164,163,91,269,267,17220,2316090.0,16952,17955.75
5787,44,34,15,30,189,188,135,134,156,324,322,25515,4133430.0,25192,26082.0
5788,46,38,11,24,132,131,141,140,113,273,271,18612,2540538.0,18340,18495.75
5789,33,28,10,18,100,99,157,156,93,257,255,15700,2017450.0,15444,16383.75
579,84,69,24,52,224,223,145,144,235,369,367,32480,5992560.0,32112,33855.75
5790,38,31,12,22,157,156,255,254,330,412,410,40035,8247210.0,39624,42230.0
5791,63,47,19,47,126,125,120,119,93,246,244,15120,1859760.0,14875,15006.0
5792,62,57,18,26,168,167,112,111,98,280,278,18816,2634240.0,18537,19460.0
5793,65,56,23,36,148,147,176,175,172,324,322,26048,4219776.0,25725,26082.0
5794,107,92,26,53,280,279,194,193,474,474,472,54320,12873840.0,53847,55932.0
5795,32,27,12,20,233,232,73,72,127,306,304,17009,2602377.0,16704,23256.0
5796,80,75,10,17,131,130,123,122,82,254,252,16113,2046351.0,15860,16002.0
5797,104,83,39,77,314,313,192,191,514,506,504,60288,15252864.0,59783,63756.0
5798,126,113,32,55,229,228,349,348,681,578,576,79921,23097169.0,79344,83232.0
5799,37,27,9,24,181,180,96,95,112,277,275,17376,2406576.0,17100,19043.75
58,49,45,14,19,136,135,176,175,144,312,310,23936,3734016.0,23625,24180.0
580,28,24,7,13,127,126,141,140,98,268,266,17907,2399538.0,17640,17822.0
5800,91,83,29,43,368,367,187,186,521,555,553,68816,19096440.0,68262,76728.75
5801,60,50,11,29,104,103,90,89,47,194,192,9360,907920.0,9167,9312.0
5802,47,42,16,24,114,113,183,182,102,297,295,20862,3098007.0,20566,21903.75
5803,60,50,20,36,229,228,162,161,255,391,389,37098,7252659.0,36708,38024.75
5804,62,48,27,50,236,235,285,284,597,521,519,67260,17521230.0,66740,67599.75
5805,38,30,15,27,151,150,162,161,130,313,311,24462,3828303.0,24150,24335.75
5806,90,82,19,33,281,280,182,181,423,463,461,51142,11839373.0,50680,53360.75
5807,58,52,13,22,96,95,174,173,79,270,268,16704,2255040.0,16435,18090.0
5808,72,56,23,53,137,136,158,157,177,295,293,21646,3192785.0,21352,21608.75
5809,60,56,5,8,172,171,161,160,212,333,331,27692,4610718.0,27360,27555.75
581,52,41,16,35,101,100,145,144,82,246,244,14645,1801335.0,14400,15006.0
5810,56,47,17,33,258,257,274,273,530,532,530,70692,18804072.0,70161,70490.0
5811,55,49,12,20,126,125,93,92,43,219,217,11718,1283121.0,11500,11880.75
5812,62,58,17,23,172,171,96,95,75,268,266,16512,2212608.0,16245,17822.0
5813,74,64,20,37,258,257,154,153,387,412,410,39732,8184792.0,39321,42230.0
5814,43,33,13,27,134,133,143,142,110,277,275,19162,2653937.0,18886,19043.75
5815,26,22,5,10,133,132,94,93,57,227,225,12502,1418977.0,12276,12768.75
5816,38,31,12,22,127,126,175,174,133,302,300,22225,3355975.0,21924,22650.0
5817,66,57,26,40,199,198,192,191,254,391,389,38208,7469664.0,37818,38024.75
5818,79,67,18,37,124,123,179,178,134,303,301,22196,3362694.0,21894,22800.75
5819,58,49,14,30,191,190,106,105,121,297,295,20246,3006531.0,19950,21903.75
582,79,56,24,67,251,250,315,314,885,566,564,79065,22375395.0,78500,79806.0
5820,139,121,42,75,282,281,451,450,2335,733,731,127182,46612203.0,126450,133955.75
5822,67,59,18,31,203,202,157,156,187,360,358,31871,5736780.0,31512,32220.0
5823,390,382,13,27,405,404,405,404,3023,810,808,164025,66430125.0,163216,163620.0
5824,56,50,18,28,139,138,153,152,111,292,290,21267,3104982.0,20976,21170.0
5826,65,50,22,49,238,237,150,149,287,388,386,35700,6925800.0,35313,37442.0
5828,43,40,11,15,82,81,123,122,56,205,203,10086,1033815.0,9882,10403.75
5829,57,51,15,24,231,230,196,195,347,427,425,45276,9666426.0,44850,45368.75
583,85,75,27,45,384,383,301,300,1371,685,683,115584,39587520.0,114900,116963.75
5830,72,54,14,44,148,147,153,152,168,301,299,22644,3407922.0,22344,22499.75
5831,45,38,17,28,164,163,208,207,195,372,370,34112,6344832.0,33741,34410.0
5832,54,42,17,39,130,129,210,209,175,340,338,27300,4641000.0,26961,28730.0
5833,61,54,18,30,108,107,168,167,108,276,274,18144,2503872.0,17869,18906.0
5834,60,46,20,45,194,193,229,228,384,423,421,44426,9396099.0,44004,44520.75
5835,59,49,14,32,271,270,205,204,476,476,474,55555,13222090.0,55080,56406.0
5836,50,41,15,31,145,144,151,150,140,296,294,21895,3240460.0,21600,21756.0
5837,27,26,10,10,216,215,286,285,720,502,500,61776,15505776.0,61275,62750.0
5838,30,23,7,13,104,103,134,133,69,238,236,13936,1658384.0,13699,14042.0
5839,52,45,16,28,162,161,118,117,115,280,278,19116,2676240.0,18837,19460.0
584,103,87,29,59,198,197,196,195,257,394,392,38808,7645176.0,38415,38612.0
5840,56,44,10,32,148,147,129,128,91,277,275,19092,2644242.0,18816,19043.75
5841,52,40,13,35,96,95,83,82,31,179,177,7968,713136.0,7790,7920.75
5842,78,64,27,53,241,240,233,232,486,474,472,56153,13308261.0,55680,55932.0
5843,90,79,28,48,207,206,369,368,694,576,574,76383,21998304.0,75808,82656.0
5844,49,42,19,31,132,131,200,199,140,332,330,26400,4382400.0,26069,27390.0
5845,96,80,35,65,236,235,271,270,465,507,505,63956,16212846.0,63450,64008.75
5847,54,49,14,21,107,106,120,119,66,227,225,12840,1457340.0,12614,12768.75
5849,76,63,19,41,165,164,122,121,113,287,285,20130,2888655.0,19844,20448.75
585,59,49,16,34,117,116,130,129,74,247,245,15210,1878435.0,14964,15128.75
5850,43,35,13,21,98,97,129,128,74,227,225,12642,1434867.0,12416,12768.75
5851,21,15,6,12,274,273,418,417,1397,692,690,114532,39628072.0,113841,119370.0
5852,39,33,10,19,119,118,81,80,40,200,198,9639,963900.0,9440,9900.0
5853,40,34,13,22,78,77,155,154,59,233,231,12090,1408485.0,11858,13455.75
5855,62,51,15,35,109,108,237,236,171,346,344,25833,4469109.0,25488,29756.0
5856,48,37,17,35,224,223,137,136,311,361,359,30688,5539184.0,30328,32399.75
5857,54,46,11,25,337,336,226,225,731,563,561,76162,21439603.0,75600,78960.75
5858,55,43,12,34,145,144,285,284,350,430,428,41325,8884875.0,40896,46010.0
5859,74,67,25,36,343,342,217,216,552,560,558,74431,20840680.0,73872,78120.0
586,56,52,13,19,157,156,125,124,111,282,280,19625,2767125.0,19344,19740.0
5860,35,27,13,24,139,138,123,122,90,262,260,17097,2239707.0,16836,17030.0
5861,36,28,10,24,170,169,107,106,90,277,275,18190,2519315.0,17914,19043.75
5862,39,31,14,27,181,180,90,89,70,271,269,16290,2207295.0,16020,18224.75
5863,66,49,21,52,186,185,150,149,159,336,334,27900,4687200.0,27565,28056.0
5864,36,30,11,19,114,113,124,123,78,238,236,14136,1682184.0,13899,14042.0
5865,93,85,19,32,172,171,228,227,241,400,398,39216,7843200.0,38817,39800.0
5866,94,83,29,49,198,197,206,205,354,404,402,40788,8239176.0,40385,40602.0
5867,71,64,20,30,180,179,101,100,106,281,279,18180,2554290.0,17900,19599.75
5868,103,98,22,30,252,251,149,148,242,401,399,37548,7528374.0,37148,39999.75
5869,85,64,27,65,213,212,193,192,254,406,404,41109,8345127.0,40704,41006.0
587,30,26,12,17,131,130,110,109,80,241,239,14410,1736405.0,14170,14399.75
5870,56,46,15,32,214,213,227,226,375,441,439,48578,10711449.0,48138,48399.75
5871,71,61,23,40,170,169,125,124,146,295,293,21250,3134375.0,20956,21608.75
5872,149,124,44,91,248,247,514,513,1517,762,760,127472,48566832.0,126711,144780.0
5873,57,45,15,37,124,123,140,139,80,264,262,17360,2291520.0,17097,17292.0
5874,61,48,21,44,226,225,206,205,322,432,430,46556,10056096.0,46125,46440.0
5875,67,62,20,26,171,170,131,130,132,302,300,22401,3382551.0,22100,22650.0
5876,25,21,8,13,87,86,195,194,81,282,280,16965,2392065.0,16684,19740.0
5877,64,53,20,40,180,179,120,119,127,300,298,21600,3240000.0,21301,22350.0
5878,52,47,15,23,233,232,108,107,141,341,339,25164,4290462.0,24824,28899.75
5879,49,40,18,34,275,274,124,123,249,399,397,34100,6802950.0,33702,39600.75
588,119,118,6,6,124,123,147,146,93,271,269,18228,2469894.0,17958,18224.75
5880,27,25,10,11,140,139,174,173,116,314,312,24360,3824520.0,24047,24492.0
5881,62,53,17,31,142,141,118,117,88,260,258,16756,2178280.0,16497,16770.0
5882,51,46,13,21,250,249,116,115,147,366,364,29000,5307000.0,28635,33306.0
5883,46,39,13,22,123,122,147,146,122,270,268,18081,2440935.0,17812,18090.0
5884,78,71,12,23,119,118,179,178,123,298,296,21301,3173849.0,21004,22052.0
5885,30,25,6,10,139,138,123,122,94,262,260,17097,2239707.0,16836,17030.0
5886,60,53,22,32,215,214,159,158,207,374,372,34185,6392595.0,33812,34782.0
5887,41,37,9,15,142,141,120,119,69,262,260,17040,2232240.0,16779,17030.0
5888,67,56,24,43,214,213,428,427,1235,642,640,91592,29401032.0,90951,102720.0
5889,21,19,6,8,136,135,116,115,87,252,250,15776,1987776.0,15525,15750.0
5890,107,89,36,70,191,190,284,283,443,475,473,54244,12882950.0,53770,56168.75
5891,50,45,16,21,103,102,159,158,95,262,260,16377,2145387.0,16116,17030.0
5892,66,58,17,30,202,201,183,182,318,385,383,36966,7115955.0,36582,36863.75
5893,37,31,13,21,127,126,140,139,91,267,265,17780,2373630.0,17514,17688.75
5894,84,79,25,33,240,239,174,173,367,414,412,41760,8644320.0,41347,42642.0
5895,58,52,17,26,154,153,209,208,211,363,361,32186,5841759.0,31824,32760.75
5896,88,74,31,56,233,232,211,210,306,444,442,49163,10914186.0,48720,49062.0
5897,45,34,10,27,101,100,98,97,48,199,197,9898,984851.0,9700,9800.75
5898,101,88,32,56,199,198,226,225,305,425,423,44974,9556975.0,44550,44943.75
5899,50,42,13,27,90,89,154,153,115,244,242,13860,1690920.0,13617,14762.0
59,64,51,21,43,251,250,154,153,308,405,403,38654,7827435.0,38250,40803.75
590,34,29,9,15,78,77,137,136,50,215,213,10686,1148745.0,10472,11448.75
5901,40,31,11,27,114,113,69,68,39,183,181,7866,719739.0,7684,8280.75
5902,50,39,19,34,147,146,160,159,144,307,305,23520,3610320.0,23214,23408.75
5903,57,47,19,36,151,150,187,186,245,338,336,28237,4772053.0,27900,28392.0
5904,64,54,16,33,157,156,132,131,152,289,287,20724,2994618.0,20436,20735.75
5905,44,35,12,28,196,195,235,234,376,431,429,46060,9925930.0,45630,46224.75
5906,148,131,50,81,426,425,357,356,2658,783,781,152082,59540103.0,151300,152880.75
5907,45,44,9,9,80,79,214,213,118,294,292,17120,2516640.0,16827,21462.0
5908,47,40,16,28,296,295,172,171,318,468,466,50912,11913408.0,50445,54522.0
5909,70,46,21,66,135,134,147,146,146,282,280,19845,2798145.0,19564,19740.0
591,71,54,23,52,192,191,216,215,303,408,406,41472,8460288.0,41065,41412.0
5910,69,55,20,44,178,177,142,141,145,320,318,25276,4044160.0,24957,25440.0
5911,195,161,56,118,394,393,509,508,3427,903,901,200546,90546519.0,199644,203400.75
5912,55,43,16,38,181,180,188,187,210,369,367,34028,6278166.0,33660,33855.75
5913,52,45,14,23,146,145,136,135,105,282,280,19856,2799696.0,19575,19740.0
5914,35,27,9,18,155,154,251,250,259,406,404,38905,7897715.0,38500,41006.0
5915,30,29,9,9,293,292,134,133,331,427,425,39262,8382437.0,38836,45368.75
5916,40,33,9,21,173,172,151,150,188,324,322,26123,4231926.0,25800,26082.0
5917,40,34,6,13,145,144,102,101,74,247,245,14790,1826565.0,14544,15128.75
5918,84,68,19,48,198,197,186,185,259,384,382,36828,7070976.0,36445,36672.0
5919,82,73,21,37,245,244,142,141,196,387,385,34790,6731865.0,34404,37248.75
592,101,74,35,84,253,252,435,434,941,688,686,110055,37858920.0,109368,117992.0
5920,56,51,20,28,250,249,194,193,434,444,442,48500,10767000.0,48057,49062.0
5921,55,49,18,27,130,129,123,122,77,253,251,15990,2022735.0,15738,15875.75
5922,67,59,23,37,223,222,225,224,580,448,446,50175,11239200.0,49728,49952.0
5924,63,56,15,27,124,123,103,102,59,227,225,12772,1449622.0,12546,12768.75
5925,89,64,31,79,421,420,440,439,2697,861,859,185240,79745820.0,184380,184899.75
5926,63,40,15,59,139,138,174,173,157,313,311,24186,3785109.0,23874,24335.75
5927,50,25,13,61,170,169,180,179,278,350,348,30600,5355000.0,30251,30450.0
5928,53,43,16,32,271,270,261,260,534,532,530,70731,18814446.0,70200,70490.0
5929,116,98,34,68,204,203,294,293,471,498,496,59976,14934024.0,59479,61752.0
593,62,46,16,38,123,122,123,122,94,246,244,15129,1860867.0,14884,15006.0
5930,22,20,6,8,119,118,100,99,72,219,217,11900,1303050.0,11682,11880.75
5931,85,74,22,42,157,156,120,119,91,277,275,18840,2609340.0,18564,19043.75
5932,48,38,16,32,141,140,249,248,335,390,388,35109,6846255.0,34720,37830.0
5933,44,38,13,22,130,129,150,149,96,280,278,19500,2730000.0,19221,19460.0
5934,44,35,15,30,123,122,133,132,94,256,254,16359,2093952.0,16104,16256.0
5935,43,34,12,27,133,132,208,207,247,341,339,27664,4716712.0,27324,28899.75
5936,151,126,51,97,457,456,415,414,3268,872,870,189655,82689580.0,188784,189660.0
5937,55,41,20,44,494,493,434,433,5859,928,926,214396,99479744.0,213469,214832.0
5938,28,23,8,15,118,117,146,145,86,264,262,17228,2274096.0,16965,17292.0
5939,39,31,14,24,129,128,146,145,130,275,273,18834,2589675.0,18560,18768.75
594,54,42,16,38,124,123,145,144,114,269,267,17980,2418310.0,17712,17955.75
5940,78,65,24,47,143,142,218,217,232,361,359,31174,5626907.0,30814,32399.75
5941,33,29,7,10,157,156,259,258,349,416,414,40663,8457904.0,40248,43056.0
5942,79,60,25,61,151,150,219,218,224,370,368,33069,6117765.0,32700,34040.0
5943,75,51,23,69,193,192,185,184,285,378,376,35705,6748245.0,35328,35532.0
5944,66,52,22,48,180,179,125,124,177,305,303,22500,3431250.0,22196,23103.75
5945,71,56,15,43,138,137,215,214,203,353,351,29670,5236755.0,29318,30975.75
5946,30,23,10,20,122,121,94,93,64,216,214,11468,1238544.0,11253,11556.0
5947,52,42,10,28,199,198,125,124,197,324,322,24875,4029750.0,24552,26082.0
5948,135,134,7,7,285,284,170,169,369,455,453,48450,11022375.0,47996,51528.75
5949,118,107,42,61,517,516,349,348,3514,866,864,180433,78127489.0,179568,187056.0
595,65,56,22,38,185,184,117,116,101,302,300,21645,3268395.0,21344,22650.0
5951,39,28,13,27,145,144,136,135,141,281,279,19720,2770660.0,19440,19599.75
5952,50,39,17,34,115,114,219,218,215,334,332,25185,4205895.0,24852,27722.0
5953,61,56,20,28,280,279,313,312,1050,593,591,87640,25985260.0,87048,87615.75
5955,127,104,43,86,528,527,287,286,1828,815,813,151536,61750920.0,150722,165648.75
5956,19,18,5,5,247,246,133,132,202,380,378,32851,6241690.0,32472,35910.0
5957,69,58,25,44,215,214,135,134,190,350,348,29025,5079375.0,28676,30450.0
5958,361,353,14,28,377,376,377,376,1990,754,752,142129,53582633.0,141376,141752.0
5959,72,67,20,28,179,178,181,180,216,360,358,32399,5831820.0,32040,32220.0
596,34,31,9,12,145,144,170,169,116,315,313,24650,3882375.0,24336,24648.75
5960,52,47,19,26,150,149,157,156,200,307,305,23550,3614925.0,23244,23408.75
5961,65,47,15,49,178,177,155,154,200,333,331,27590,4593735.0,27258,27555.75
5962,26,24,6,7,154,153,81,80,74,235,233,12474,1465695.0,12240,13688.75
5963,47,36,18,37,222,221,209,208,380,431,429,46398,9998769.0,45968,46224.75
5964,100,88,14,33,154,153,216,215,240,370,368,33264,6153840.0,32895,34040.0
5965,86,78,22,36,148,147,208,207,262,356,354,30784,5479552.0,30429,31506.0
5966,47,40,13,23,222,221,125,124,150,347,345,27750,4814625.0,27404,29928.75
5967,97,89,22,36,147,146,171,170,157,318,316,25137,3996783.0,24820,25122.0
5968,47,43,14,20,76,75,176,175,75,252,250,13376,1685376.0,13125,15750.0
5969,67,65,17,19,131,130,185,184,138,316,314,24235,3829130.0,23920,24806.0
597,113,98,33,61,318,317,203,202,503,521,519,64554,16816317.0,64034,67599.75
5970,55,48,17,29,135,134,99,98,59,234,232,13365,1563705.0,13132,13572.0
5971,20,19,5,5,132,131,198,197,151,330,328,26136,4312440.0,25807,27060.0
5972,72,64,20,34,151,150,158,157,117,309,307,23858,3686061.0,23550,23715.75
5973,39,33,10,16,160,159,118,117,100,278,276,18880,2624320.0,18603,19182.0
5974,78,59,26,61,202,201,211,210,307,413,411,42622,8801443.0,42210,42435.75
5975,65,55,24,41,518,517,476,475,4968,994,992,246568,122544296.0,245575,246512.0
5976,57,51,12,22,94,93,134,133,56,228,226,12596,1435944.0,12369,12882.0
5977,37,31,17,26,155,154,141,140,155,296,294,21855,3234540.0,21560,21756.0
5978,36,31,15,20,115,114,198,197,126,313,311,22770,3563505.0,22458,24335.75
5979,52,43,21,36,229,228,224,223,371,453,451,51296,11618544.0,50844,51075.75
598,77,72,18,26,161,160,123,122,99,284,282,19803,2812026.0,19520,20022.0
5980,36,32,11,16,132,131,116,115,64,248,246,15312,1898688.0,15065,15252.0
5981,46,39,18,30,124,123,169,168,136,293,291,20956,3070054.0,20664,21315.75
5982,55,48,19,31,132,131,197,196,155,329,327,26004,4277658.0,25676,26895.75
5983,70,62,20,33,222,221,166,165,228,388,386,36852,7149288.0,36465,37442.0
5984,25,23,5,6,149,148,304,303,391,453,451,45296,10259544.0,44844,51075.75
5985,78,75,15,19,138,137,133,132,69,271,269,18354,2486967.0,18084,18224.75
5986,42,32,7,16,64,63,132,131,43,196,194,8448,827904.0,8253,9506.0
5987,98,79,30,66,210,209,296,295,568,506,504,62160,15726480.0,61655,63756.0
5988,38,33,14,20,126,125,86,85,49,212,210,10836,1148616.0,10625,11130.0
5989,61,45,21,50,162,161,127,126,151,289,287,20574,2972943.0,20286,20735.75
599,58,48,22,39,174,173,195,194,272,369,367,33930,6260085.0,33562,33855.75
5990,54,43,18,36,287,286,210,209,642,497,495,60270,14977095.0,59774,61503.75
5991,171,170,7,7,178,177,178,177,177,356,354,31684,5639752.0,31329,31506.0
5992,47,39,12,22,168,167,141,140,159,309,307,23688,3659796.0,23380,23715.75
5993,68,59,17,31,238,237,178,177,310,416,414,42364,8811712.0,41949,43056.0
5994,36,34,12,14,182,181,319,318,443,501,499,58058,14543529.0,57558,62499.75
5995,99,86,28,50,196,195,350,349,630,546,544,68600,18727800.0,68055,74256.0
5996,41,35,10,20,84,83,156,155,67,240,238,13104,1572480.0,12865,14280.0
5997,98,89,23,39,204,203,269,268,473,473,471,54876,12978174.0,54404,55695.75
5998,56,41,14,36,214,213,154,153,210,368,366,32956,6063904.0,32589,33672.0
5999,24,23,7,7,101,100,99,98,44,200,198,9999,999900.0,9800,9900.0
60,43,41,12,14,331,330,197,196,466,528,526,65207,17214648.0,64680,69432.0
6000,76,61,29,55,184,183,308,307,421,492,490,56672,13941312.0,56181,60270.0
6001,54,44,17,34,156,155,129,128,124,285,283,20124,2867670.0,19840,20163.75
6002,85,79,18,25,157,156,284,283,389,441,439,44588,9831654.0,44148,48399.75
6003,48,41,17,29,115,114,210,209,175,325,323,24150,3924375.0,23826,26243.75
6004,83,67,28,57,306,305,487,486,2053,793,791,149022,59087223.0,148230,156815.75
6005,47,42,11,19,176,175,206,205,176,382,380,36256,6924896.0,35875,36290.0
6006,43,39,11,16,173,172,107,106,105,280,278,18511,2591540.0,18232,19460.0
6007,67,54,16,40,136,135,126,125,103,262,260,17136,2244816.0,16875,17030.0
6008,59,51,18,31,190,189,127,126,183,317,315,24130,3824605.0,23814,24963.75
6009,62,54,15,29,124,123,106,105,69,230,228,13144,1511560.0,12915,13110.0
601,88,74,28,53,264,263,219,218,332,483,481,57816,13962564.0,57334,58080.75
6010,46,35,16,35,140,139,190,189,171,330,328,26600,4389000.0,26271,27060.0
6011,106,86,27,62,302,301,332,331,758,634,632,100264,31783688.0,99631,100172.0
6012,66,57,19,35,157,156,157,156,136,314,312,24649,3869893.0,24336,24492.0
6013,58,49,18,32,176,175,142,141,191,318,316,24992,3973728.0,24675,25122.0
6014,69,56,19,42,157,156,236,235,278,393,391,37052,7280718.0,36660,38415.75
6015,71,59,21,41,237,236,384,383,1044,621,619,91008,28257984.0,90388,96099.75
6016,82,65,24,55,254,253,164,163,318,418,416,41656,8706104.0,41239,43472.0
6017,76,63,24,48,165,164,221,220,322,386,384,36465,7037745.0,36080,37056.0
6018,60,47,20,42,124,123,119,118,91,243,241,14756,1792854.0,14514,14640.75
6019,64,59,18,25,135,134,173,172,145,308,306,23355,3596670.0,23048,23562.0
602,78,64,20,44,194,193,222,221,313,416,414,43068,8958144.0,42653,43056.0
6020,55,49,15,25,97,96,176,175,87,273,271,17072,2330328.0,16800,18495.75
6021,178,177,13,13,193,192,193,192,335,386,384,37249,7189057.0,36864,37056.0
6022,69,57,25,45,362,361,217,216,839,579,577,78554,22741383.0,77976,83520.75
6023,78,69,20,35,199,198,130,129,164,329,327,25870,4255615.0,25542,26895.75
6024,20,19,4,4,74,73,90,89,24,164,162,6660,546120.0,6497,6642.0
6025,65,53,17,39,126,125,164,163,161,290,288,20664,2996280.0,20375,20880.0
6026,58,48,18,36,165,164,139,138,113,304,302,22935,3486120.0,22632,22952.0
6027,44,37,14,26,107,106,96,95,50,203,201,10272,1042608.0,10070,10200.75
6028,71,61,22,40,198,197,163,162,168,361,359,32274,5825457.0,31914,32399.75
6029,78,68,19,37,179,178,258,257,358,437,435,46182,10090767.0,45746,47523.75
603,41,36,11,18,112,111,117,116,59,229,227,13104,1500408.0,12876,12995.75
6030,68,61,19,31,207,206,150,149,297,357,355,31050,5542425.0,30694,31683.75
6031,49,37,18,40,175,174,132,131,135,307,305,23100,3545850.0,22794,23408.75
6032,49,45,14,20,169,168,136,135,115,305,303,22984,3505060.0,22680,23103.75
6033,31,25,9,14,146,145,86,85,69,232,230,12556,1456496.0,12325,13340.0
6034,65,54,19,39,166,165,133,132,126,299,297,22078,3300661.0,21780,22200.75
6035,73,69,23,29,146,145,143,142,120,289,287,20878,3016871.0,20590,20735.75
6036,44,37,16,28,251,250,130,129,180,381,379,32630,6216015.0,32250,36099.75
6037,55,43,19,41,114,113,170,169,118,284,282,19380,2751960.0,19097,20022.0
6038,37,34,12,16,129,128,126,125,81,255,253,16254,2072385.0,16000,16128.75
6039,38,34,15,21,232,231,146,145,226,378,376,33872,6401808.0,33495,35532.0
604,43,38,12,19,136,135,104,103,66,240,238,14144,1697280.0,13905,14280.0
6040,95,94,3,3,124,123,147,146,95,271,269,18228,2469894.0,17958,18224.75
6041,103,91,32,54,224,223,247,246,447,471,469,55328,13029744.0,54858,55224.75
6043,53,45,19,32,369,368,259,258,1100,628,626,95571,30009294.0,94944,98282.0
6044,60,51,19,34,138,137,135,134,100,273,271,18630,2542995.0,18358,18495.75
6046,29,22,5,11,134,133,103,102,82,237,235,13802,1635537.0,13566,13923.75
6047,62,51,13,32,157,156,179,178,198,336,334,28103,4721304.0,27768,28056.0
6048,55,48,21,33,179,178,123,122,117,302,300,22017,3324567.0,21716,22650.0
6049,44,28,12,42,150,149,127,126,134,277,275,19050,2638425.0,18774,19043.75
605,119,118,6,6,147,146,124,123,93,271,269,18228,2469894.0,17958,18224.75
6050,29,25,10,15,98,97,79,78,31,177,175,7742,685167.0,7566,7743.75
6052,46,36,16,34,94,93,163,162,82,257,255,15322,1968877.0,15066,16383.75
6053,76,58,27,60,190,189,196,195,240,386,384,37240,7187320.0,36855,37056.0
6054,115,101,34,60,360,359,245,244,1053,605,603,88200,26680500.0,87596,91203.75
6055,53,40,17,41,91,90,129,128,88,220,218,11739,1291290.0,11520,11990.0
6056,25,22,10,14,111,110,142,141,77,253,251,15762,1993893.0,15510,15875.75
6057,77,63,20,46,148,147,159,158,156,307,305,23532,3612162.0,23226,23408.75
6059,49,42,15,27,143,142,162,161,134,305,303,23166,3532815.0,22862,23103.75
606,37,30,16,27,92,91,286,285,237,378,376,26312,4972968.0,25935,35532.0
6060,88,75,22,46,190,189,212,211,302,402,400,40280,8096280.0,39879,40200.0
6061,113,76,35,105,239,238,280,279,834,519,517,66920,17365740.0,66402,67080.75
6062,43,40,12,16,132,131,124,123,81,256,254,16368,2095104.0,16113,16256.0
6063,37,31,11,19,152,151,97,96,84,249,247,14744,1835628.0,14496,15375.75
6064,122,115,12,23,170,169,178,177,216,348,346,30260,5265240.0,29913,30102.0
6065,40,38,8,10,127,126,150,149,96,277,275,19050,2638425.0,18774,19043.75
6066,312,311,10,10,405,404,321,320,1735,726,724,130005,47191815.0,129280,131406.0
6067,26,20,7,16,117,116,199,198,181,316,314,23283,3678714.0,22968,24806.0
6068,21,20,6,6,189,188,110,109,120,299,297,20790,3108105.0,20492,22200.75
6069,32,26,8,14,78,77,113,112,45,191,189,8814,841737.0,8624,9024.75
607,61,52,24,39,138,137,230,229,261,368,366,31740,5840160.0,31373,33672.0
6070,40,23,8,40,112,111,129,128,106,241,239,14448,1740984.0,14208,14399.75
6071,56,47,15,28,190,189,175,174,247,365,363,33250,6068125.0,32886,33123.75
6072,58,46,12,24,129,128,126,125,107,255,253,16254,2072385.0,16000,16128.75
6073,85,67,22,55,214,213,216,215,336,430,428,46224,9938160.0,45795,46010.0
6074,115,114,5,5,124,123,170,169,116,294,292,21080,3098760.0,20787,21462.0
6075,52,45,15,25,188,187,384,383,748,572,570,72192,20646912.0,71621,81510.0
6076,22,20,4,6,168,167,90,89,82,258,256,15120,1950480.0,14863,16512.0
6077,67,57,22,38,495,494,267,266,1864,762,760,132165,50354865.0,131404,144780.0
6078,19,18,6,6,101,100,160,159,80,261,259,16160,2108880.0,15900,16899.75
6079,58,46,18,40,149,148,291,290,338,440,438,43359,9538980.0,42920,48180.0
608,50,47,15,19,145,144,139,138,107,284,282,20155,2862010.0,19872,20022.0
6080,51,44,18,28,124,123,96,95,67,220,218,11904,1309440.0,11685,11990.0
6081,58,47,21,41,177,176,181,180,224,358,356,32037,5734623.0,31680,31862.0
6082,88,76,30,52,192,191,302,301,469,494,492,57984,14322048.0,57491,60762.0
6083,46,41,13,21,152,151,120,119,98,272,270,18240,2480640.0,17969,18360.0
6084,71,62,13,25,124,123,105,104,65,229,227,13020,1490790.0,12792,12995.75
6085,57,42,19,47,392,391,145,144,455,537,535,56840,15261540.0,56304,71823.75
6086,119,114,28,36,168,167,259,258,293,427,425,43512,9289812.0,43086,45368.75
6087,87,70,28,60,195,194,164,163,204,359,357,31980,5740410.0,31622,32040.75
6088,76,65,24,42,154,153,133,132,145,287,285,20482,2939167.0,20196,20448.75
609,51,44,16,28,118,117,96,95,50,214,212,11328,1212096.0,11115,11342.0
6090,220,176,65,151,531,530,430,429,6802,961,959,228330,109712565.0,227370,230399.75
6091,96,79,31,62,241,240,215,214,318,456,454,51815,11813820.0,51360,51756.0
6092,53,41,15,37,138,137,194,193,191,332,330,26772,4444152.0,26441,27390.0
6093,43,38,13,19,154,153,153,152,129,307,305,23562,3616767.0,23256,23408.75
6094,114,113,4,4,124,123,147,146,104,271,269,18228,2469894.0,17958,18224.75
6095,35,31,12,17,174,173,130,129,140,304,302,22620,3438240.0,22317,22952.0
6096,83,68,32,58,256,255,398,397,827,654,652,101888,33317376.0,101235,106602.0
6097,30,27,8,12,155,154,155,154,128,310,308,24025,3723875.0,23716,23870.0
6098,115,114,5,5,170,169,124,123,112,294,292,21080,3098760.0,20787,21462.0
6099,42,37,11,18,79,78,237,236,167,316,314,18723,2958234.0,18408,24806.0
61,38,36,11,13,280,279,135,134,288,415,413,37800,7843500.0,37386,42848.75
610,76,64,20,42,179,178,141,140,204,320,318,25239,4038240.0,24920,25440.0
6100,66,46,19,54,116,115,167,166,155,283,281,19372,2741138.0,19090,19880.75
6101,51,40,19,36,154,153,146,145,132,300,298,22484,3372600.0,22185,22350.0
6102,44,41,14,18,146,145,155,154,113,301,299,22630,3405815.0,22330,22499.75
6103,47,41,11,20,138,137,118,117,109,256,254,16284,2084352.0,16029,16256.0
6104,77,67,26,44,189,188,268,267,540,457,455,50652,11573982.0,50196,51983.75
6105,53,44,18,32,274,273,255,254,468,529,527,69870,18480615.0,69342,69695.75
6106,29,24,9,15,117,116,110,109,80,227,225,12870,1460745.0,12644,12768.75
6107,93,74,29,63,230,229,203,202,295,433,431,46690,10108385.0,46258,46655.75
6108,96,75,33,70,394,393,283,282,1226,677,675,111502,37743427.0,110826,114243.75
6109,54,49,21,29,80,79,144,143,56,224,222,11520,1290240.0,11297,12432.0
611,61,47,19,45,196,195,162,161,217,358,356,31752,5683608.0,31395,31862.0
6110,83,71,26,44,241,240,229,228,518,470,468,55189,12969415.0,54720,54990.0
6111,73,64,20,35,165,164,154,153,218,319,317,25410,4052895.0,25092,25280.75
6112,89,73,26,55,410,409,435,434,1761,845,843,178350,75352875.0,177506,178083.75
6113,111,89,39,81,221,220,240,239,349,461,459,53040,12225720.0,52580,52899.75
6114,112,87,33,81,246,245,352,351,829,598,596,86592,25891008.0,85995,89102.0
6115,76,65,19,39,155,154,134,133,111,289,287,20770,3001265.0,20482,20735.75
6116,57,54,13,17,130,129,159,158,107,289,287,20670,2986815.0,20382,20735.75
6117,69,62,19,31,154,153,144,143,127,298,296,22176,3304224.0,21879,22052.0
6119,41,32,11,27,122,121,97,96,56,219,217,11834,1295823.0,11616,11880.75
612,118,95,35,76,226,225,261,260,534,487,485,58986,14363091.0,58500,59048.75
6121,79,68,31,50,251,250,255,254,519,506,504,64005,16193265.0,63500,63756.0
6122,61,42,17,52,163,162,159,158,156,322,320,25917,4172637.0,25596,25760.0
6123,99,77,25,63,207,206,353,352,639,560,558,73071,20459880.0,72512,78120.0
6124,27,23,10,16,131,130,90,89,67,221,219,11790,1302795.0,11570,12099.75
6125,50,42,14,28,105,104,128,127,110,233,231,13440,1565760.0,13208,13455.75
6126,167,126,53,130,483,482,381,380,3253,864,862,184023,79497936.0,183160,186192.0
6127,64,50,15,41,212,211,115,114,137,327,325,24380,3986130.0,24054,26568.75
6128,113,108,12,19,178,177,216,215,309,394,392,38448,7574256.0,38055,38612.0
6129,59,48,16,33,111,110,132,131,70,243,241,14652,1780218.0,14410,14640.75
613,29,25,12,17,192,191,100,99,120,292,290,19200,2803200.0,18909,21170.0
6130,69,59,15,33,177,176,117,116,152,294,292,20709,3044223.0,20416,21462.0
6131,57,43,16,41,137,136,201,200,208,338,336,27537,4653753.0,27200,28392.0
6132,70,65,11,19,107,106,151,150,84,258,256,16157,2084253.0,15900,16512.0
6133,20,18,8,9,187,186,132,131,130,319,317,24684,3937098.0,24366,25280.75
6134,60,50,19,37,156,155,119,118,94,275,273,18564,2552550.0,18290,18768.75
6135,72,67,17,25,193,192,167,166,195,360,358,32231,5801580.0,31872,32220.0
6136,27,20,8,16,120,119,171,170,129,291,289,20520,2985660.0,20230,21024.75
6137,33,27,9,18,169,168,127,126,143,296,294,21463,3176524.0,21168,21756.0
6138,84,76,24,38,168,167,248,247,278,416,414,41664,8666112.0,41249,43056.0
6139,87,76,27,47,201,200,199,198,288,400,398,39999,7999800.0,39600,39800.0
614,157,136,47,87,424,423,438,437,2623,862,860,185712,80041872.0,184851,185330.0
6140,82,74,19,33,119,118,134,133,105,253,251,15946,2017169.0,15694,15875.75
6142,171,170,7,7,178,177,178,177,167,356,354,31684,5639752.0,31329,31506.0
6143,95,82,30,54,153,152,278,277,468,431,429,42534,9166077.0,42104,46224.75
6144,68,55,25,48,146,145,154,153,150,300,298,22484,3372600.0,22185,22350.0
6146,46,38,15,28,141,140,109,108,69,250,248,15369,1921125.0,15120,15500.0
6147,42,32,14,32,156,155,273,272,448,429,427,42588,9135126.0,42160,45795.75
6148,44,29,11,39,194,193,183,182,301,377,375,35502,6692127.0,35126,35343.75
6149,33,30,10,14,142,141,97,96,83,239,237,13774,1645993.0,13536,14160.75
615,46,38,15,29,192,191,100,99,93,292,290,19200,2803200.0,18909,21170.0
6150,35,31,12,18,182,181,101,100,95,283,281,18382,2601053.0,18100,19880.75
6151,84,68,25,54,178,177,186,185,197,364,362,33108,6025656.0,32745,32942.0
6152,85,62,26,67,354,353,283,282,1050,637,635,100182,31907967.0,99546,101123.75
6153,69,55,15,41,136,135,209,208,196,345,343,28424,4903140.0,28080,29583.75
6154,181,180,13,13,216,215,193,192,325,409,407,41688,8525196.0,41280,41615.75
6155,92,70,27,68,183,182,235,234,330,418,416,43005,8988045.0,42588,43472.0
6156,130,99,36,96,307,306,341,340,862,648,646,104687,33918588.0,104040,104652.0
6158,43,39,11,17,93,92,76,75,46,169,167,7068,597246.0,6900,7055.75
6159,134,109,31,78,421,420,298,297,1349,719,717,125458,45102151.0,124740,128880.75
616,60,42,17,45,141,140,234,233,194,375,373,32994,6186375.0,32620,34968.75
6160,67,56,16,29,132,131,119,118,72,251,249,15708,1971354.0,15458,15624.75
6161,77,66,20,37,183,182,200,199,239,383,381,36600,7008900.0,36218,36480.75
6162,56,46,16,34,114,113,203,202,151,317,315,23142,3668007.0,22826,24963.75
6163,60,45,23,51,159,158,198,197,227,357,355,31482,5619537.0,31126,31683.75
6164,40,31,12,25,103,102,108,107,67,211,209,11124,1173582.0,10914,11024.75
6165,65,59,17,27,202,201,160,159,177,362,360,32320,5849920.0,31959,32580.0
6166,51,40,14,28,106,105,102,101,59,208,206,10812,1124448.0,10605,10712.0
6167,62,51,20,40,215,214,357,356,888,572,570,76755,21951930.0,76184,81510.0
6168,168,136,56,117,449,448,436,435,3656,885,883,195764,86625570.0,194880,195363.75
6169,54,42,17,36,113,112,171,170,116,284,282,19323,2743866.0,19040,20022.0
617,77,69,21,34,135,134,148,147,99,283,281,19980,2827170.0,19698,19880.75
6170,79,66,31,55,218,217,249,248,448,467,465,54282,12674847.0,53816,54288.75
6171,90,84,19,28,195,194,132,131,148,327,325,25740,4208490.0,25414,26568.75
6172,28,25,8,12,175,174,217,216,391,392,390,37975,7443100.0,37584,38220.0
6173,69,61,22,36,154,153,237,236,277,391,389,36498,7135359.0,36108,38024.75
6174,38,30,14,26,133,132,156,155,130,289,287,20748,2998086.0,20460,20735.75
6175,51,39,13,34,132,131,133,132,97,265,263,17556,2326170.0,17292,17423.75
6176,122,97,28,76,272,271,168,167,385,440,438,45696,10053120.0,45257,48180.0
6177,119,118,6,6,193,192,147,146,183,340,338,28371,4823070.0,28032,28730.0
6178,171,170,7,7,178,177,178,177,176,356,354,31684,5639752.0,31329,31506.0
6179,59,49,17,35,131,130,165,164,101,296,294,21615,3199020.0,21320,21756.0
618,56,42,17,43,478,477,188,187,1046,666,664,89864,29924712.0,89199,110556.0
6180,49,45,12,18,183,182,150,149,174,333,331,27450,4570425.0,27118,27555.75
6181,48,41,15,25,228,227,118,117,147,346,344,26904,4654392.0,26559,29756.0
6182,80,66,29,52,267,266,280,279,568,547,545,74760,20446860.0,74214,74528.75
6183,49,40,20,36,190,189,190,189,196,380,378,36100,6859000.0,35721,35910.0
6184,33,31,8,10,117,116,152,151,84,269,267,17784,2391948.0,17516,17955.75
6185,83,76,20,30,235,234,295,294,735,530,528,69325,18371125.0,68796,69960.0
6186,67,60,18,29,226,225,152,151,219,378,376,34352,6492528.0,33975,35532.0
6187,85,78,16,28,161,160,162,161,132,323,321,26082,4212243.0,25760,25920.75
6188,73,62,25,44,327,326,203,202,765,530,528,66381,17590965.0,65852,69960.0
6189,63,53,20,38,253,252,331,330,1117,584,582,83743,24452956.0,83160,84972.0
619,58,48,17,34,133,132,252,251,324,385,383,33516,6451830.0,33132,36863.75
6190,71,63,19,33,212,211,137,136,170,349,347,29044,5068178.0,28696,30275.75
6191,23,18,9,16,139,138,112,111,85,251,249,15568,1953784.0,15318,15624.75
6192,72,62,21,39,170,169,300,299,326,470,468,51000,11985000.0,50531,54990.0
6193,71,65,14,23,171,170,144,143,141,315,313,24624,3878280.0,24310,24648.75
6194,51,37,19,44,135,134,104,103,80,239,237,14040,1677780.0,13802,14160.75
6195,44,34,7,25,174,173,145,144,197,319,317,25230,4024185.0,24912,25280.75
6196,49,40,16,32,229,228,180,179,376,409,407,41220,8429490.0,40812,41615.75
6197,88,70,28,59,245,244,245,244,640,490,488,60025,14706125.0,59536,59780.0
6198,62,49,17,38,230,229,145,144,261,375,373,33350,6253125.0,32976,34968.75
6199,56,40,16,45,114,113,129,128,80,243,241,14706,1786779.0,14464,14640.75
62,75,56,28,58,279,278,218,217,517,497,495,60822,15114267.0,60326,61503.75
620,57,51,16,26,243,242,257,256,419,500,498,62451,15612750.0,61952,62250.0
6200,98,84,21,47,179,178,240,239,291,419,417,42960,9000120.0,42542,43680.75
6201,78,70,24,38,179,178,204,203,225,383,381,36516,6992814.0,36134,36480.75
6202,83,64,26,60,237,236,304,303,508,541,539,72048,19488984.0,71508,72899.75
6203,40,35,11,19,82,81,137,136,51,219,217,11234,1230123.0,11016,11880.75
6204,34,31,12,16,165,164,104,103,107,269,267,17160,2308020.0,16892,17955.75
6205,86,75,17,37,168,167,181,180,182,349,347,30408,5306196.0,30060,30275.75
6206,35,29,12,20,136,135,120,119,77,256,254,16320,2088960.0,16065,16256.0
6207,73,55,23,56,322,321,182,181,533,504,502,58604,14768208.0,58101,63252.0
6208,68,58,23,38,149,148,134,133,110,283,281,19966,2825189.0,19684,19880.75
6209,55,43,17,37,226,225,113,112,154,339,337,25538,4328691.0,25200,28560.75
6210,57,41,19,37,180,179,216,215,251,396,394,38880,7698240.0,38485,39006.0
6211,354,340,19,45,405,404,377,376,2257,782,780,152685,59699835.0,151904,152490.0
6212,54,48,13,23,224,223,142,141,240,366,364,31808,5820864.0,31443,33306.0
6213,81,65,32,62,264,263,345,344,901,609,607,91080,27733860.0,90472,92415.75
6214,135,110,43,87,348,347,308,307,968,656,654,107184,35156352.0,106529,107256.0
6215,30,20,6,21,103,102,121,120,67,224,222,12463,1395856.0,12240,12432.0
6216,151,118,46,104,309,308,272,271,977,581,579,84048,24415944.0,83468,84099.75
6217,20,17,5,8,116,115,111,110,87,227,225,12876,1461426.0,12650,12768.75
6218,84,69,26,54,223,222,331,330,837,554,552,73813,20446201.0,73260,76452.0
6219,66,58,22,34,217,216,170,169,230,387,385,36890,7138215.0,36504,37248.75
622,48,42,16,25,113,112,194,193,132,307,305,21922,3365027.0,21616,23408.75
6220,55,44,15,32,123,122,102,101,70,225,223,12546,1411425.0,12322,12543.75
6221,61,51,23,40,260,259,146,145,271,406,404,37960,7705880.0,37555,41006.0
6222,39,36,9,13,147,146,88,87,80,235,233,12936,1519980.0,12702,13688.75
6223,65,59,14,24,225,224,97,96,135,322,320,21825,3513825.0,21504,25760.0
6224,49,41,15,28,213,212,134,133,162,347,345,28542,4952037.0,28196,29928.75
6225,36,32,9,12,81,80,133,132,80,214,212,10773,1152711.0,10560,11342.0
6226,61,56,17,23,163,162,158,157,133,321,319,25754,4133517.0,25434,25599.75
6227,83,71,28,50,184,183,247,246,465,431,429,45448,9794044.0,45018,46224.75
6228,81,67,25,51,159,158,196,195,215,355,353,31164,5531610.0,30810,31328.75
6229,63,53,18,34,168,167,213,212,339,381,379,35784,6816852.0,35404,36099.75
623,389,381,13,27,405,404,405,404,3107,810,808,164025,66430125.0,163216,163620.0
6230,36,29,8,19,113,112,137,136,129,250,248,15481,1935125.0,15232,15500.0
6231,41,35,8,17,93,92,127,126,55,220,218,11811,1299210.0,11592,11990.0
6232,119,104,39,67,454,453,341,340,1863,795,793,154814,61538565.0,154020,157608.75
6233,48,42,15,23,129,128,148,147,100,277,275,19092,2644242.0,18816,19043.75
6234,46,35,17,37,158,157,269,268,332,427,425,42502,9074177.0,42076,45368.75
6235,60,51,16,31,129,128,165,164,113,294,292,21285,3128895.0,20992,21462.0
6236,46,43,10,14,99,98,184,183,112,283,281,18216,2577564.0,17934,19880.75
6237,59,51,16,29,178,177,103,102,101,281,279,18334,2575927.0,18054,19599.75
6238,56,44,20,42,123,122,182,181,172,305,303,22386,3413865.0,22082,23103.75
6239,24,22,9,11,137,136,151,150,151,288,286,20687,2978928.0,20400,20592.0
624,67,53,22,45,189,188,225,224,266,414,412,42525,8802675.0,42112,42642.0
6240,87,78,20,36,152,151,194,193,250,346,344,29488,5101424.0,29143,29756.0
6241,73,60,22,43,226,225,141,140,269,367,365,31866,5847411.0,31500,33488.75
6242,48,40,13,26,107,106,126,125,77,233,231,13482,1570653.0,13250,13455.75
6243,94,88,23,33,118,117,240,239,278,358,356,28320,5069280.0,27963,31862.0
6244,98,79,33,68,239,238,351,350,1016,590,588,83889,24747255.0,83300,86730.0
6245,57,47,14,30,138,137,155,154,127,293,291,21390,3133635.0,21098,21315.75
6247,71,56,26,53,175,174,196,195,213,371,369,34300,6362650.0,33930,34224.75
6248,62,52,19,37,362,361,199,198,468,561,559,72038,20206659.0,71478,78399.75
6249,63,54,22,37,144,143,227,226,182,371,369,32688,6063624.0,32318,34224.75
625,157,130,42,92,346,345,412,411,1841,758,756,142552,54027208.0,141795,143262.0
6251,54,47,19,31,222,221,404,403,725,626,624,89688,28072344.0,89063,97656.0
6252,39,28,15,35,154,153,119,118,94,273,271,18326,2501499.0,18054,18495.75
6253,92,70,26,65,228,227,239,238,517,467,465,54492,12723882.0,54026,54288.75
6254,53,37,17,47,151,150,109,108,86,260,258,16459,2139670.0,16200,16770.0
6255,79,70,23,39,153,152,148,147,123,301,299,22644,3407922.0,22344,22499.75
6256,97,87,26,44,175,174,313,312,704,488,486,54775,13365100.0,54288,59292.0
6257,72,51,27,67,158,157,259,258,331,417,415,40922,8532237.0,40506,43263.75
6258,48,42,13,21,177,176,215,214,249,392,390,38055,7458780.0,37664,38220.0
6259,102,86,30,59,157,156,328,327,446,485,483,51496,12487780.0,51012,58563.75
626,67,55,17,39,126,125,161,160,99,287,285,20286,2911041.0,20000,20448.75
6260,71,59,22,43,340,339,162,161,410,502,500,55080,13825080.0,54579,62750.0
6261,47,42,13,19,115,114,90,89,48,205,203,10350,1060875.0,10146,10403.75
6262,60,50,24,41,165,164,225,224,197,390,388,37125,7239375.0,36736,37830.0
6263,115,101,39,64,265,264,313,312,703,578,576,82945,23971105.0,82368,83232.0
6264,37,30,9,19,138,137,147,146,127,285,283,20286,2890755.0,20002,20163.75
6265,179,148,55,115,481,480,400,399,2177,881,879,192400,84752200.0,191520,193599.75
6266,79,60,26,60,145,144,153,152,175,298,296,22185,3305565.0,21888,22052.0
6267,88,63,28,72,229,228,314,313,830,543,541,71906,19522479.0,71364,73440.75
6268,44,41,13,17,263,262,214,213,633,477,475,56282,13423257.0,55806,56643.75
6269,48,39,20,33,149,148,155,154,141,304,302,23095,3510440.0,22792,22952.0
627,54,43,16,36,102,101,127,126,81,229,227,12954,1483233.0,12726,12995.75
6270,36,25,7,17,117,116,225,224,201,342,340,26325,4501575.0,25984,29070.0
6272,68,57,24,43,171,170,151,150,169,322,320,25821,4157181.0,25500,25760.0
6273,83,74,27,43,244,243,150,149,315,394,392,36600,7210200.0,36207,38612.0
6274,63,52,22,42,195,194,317,316,485,512,510,61815,15824640.0,61304,65280.0
6275,110,87,38,82,281,280,320,319,983,601,599,89920,27020960.0,89320,89999.75
6276,58,49,17,27,197,196,118,117,144,315,313,23246,3661245.0,22932,24648.75
6277,57,54,17,21,109,108,105,104,63,214,212,11445,1224615.0,11232,11342.0
6278,69,51,17,50,116,115,126,125,95,242,240,14616,1768536.0,14375,14520.0
6279,29,27,7,9,114,113,148,147,92,262,260,16872,2210232.0,16611,17030.0
628,36,24,13,35,261,260,233,232,514,494,492,60813,15020811.0,60320,60762.0
6280,43,33,13,29,234,233,174,173,269,408,406,40716,8306064.0,40309,41412.0
6281,68,55,15,38,129,128,120,119,104,249,247,15480,1927260.0,15232,15375.75
6282,41,26,10,36,180,179,217,216,317,397,395,39060,7753410.0,38664,39203.75
6283,33,28,12,19,103,102,121,120,60,224,222,12463,1395856.0,12240,12432.0
6284,42,32,13,30,152,151,158,157,144,310,308,24016,3722480.0,23707,23870.0
6285,74,58,15,45,187,186,176,175,331,363,361,32912,5973528.0,32550,32760.75
6286,60,50,19,36,230,229,148,147,205,378,376,34040,6433560.0,33663,35532.0
6287,102,88,36,58,206,205,347,346,718,553,551,71482,19764773.0,70930,76175.75
6288,71,60,14,32,120,119,147,146,147,267,265,17640,2354940.0,17374,17688.75
6289,52,49,12,16,126,125,225,224,182,351,349,28350,4975425.0,28000,30624.75
629,74,61,26,50,230,229,205,204,323,435,433,47150,10255125.0,46716,47088.75
6290,73,64,21,36,262,261,138,137,193,400,398,36156,7231200.0,35757,39800.0
6291,53,40,12,31,106,105,144,143,87,250,248,15264,1908000.0,15015,15500.0
6292,78,71,21,33,242,241,146,145,237,388,386,35332,6854408.0,34945,37442.0
6294,135,124,31,51,246,245,179,178,365,425,423,44034,9357225.0,43610,44943.75
6295,41,35,12,20,193,192,114,113,192,307,305,22002,3377307.0,21696,23408.75
6296,135,102,40,104,240,239,253,252,721,493,491,60720,14967480.0,60228,60515.75
6297,120,97,40,84,381,380,396,395,1709,777,775,150876,58615326.0,150100,150543.75
6298,102,79,40,82,546,545,416,415,3483,962,960,227136,109252416.0,226175,230880.0
6299,36,34,7,9,137,136,187,186,195,324,322,25619,4150278.0,25296,26082.0
63,41,37,15,21,278,277,175,174,495,453,451,48650,11019225.0,48198,51075.75
630,94,76,35,69,403,402,275,274,966,678,676,110825,37569675.0,110148,114582.0
6300,134,113,42,80,330,329,382,381,1482,712,710,126060,44877360.0,125349,126380.0
6301,33,30,11,15,187,186,80,79,72,267,265,14960,1997160.0,14694,17688.75
6302,139,138,9,9,147,146,170,169,147,317,315,24990,3960915.0,24674,24963.75
6303,110,92,27,61,217,216,396,395,1358,613,611,85932,26338158.0,85320,93635.75
6304,46,36,9,19,127,126,134,133,100,261,259,17018,2220849.0,16758,16899.75
6305,70,59,18,32,158,157,158,157,139,316,314,24964,3944312.0,24649,24806.0
6306,53,42,16,36,200,199,148,147,171,348,346,29600,5150400.0,29253,30102.0
6307,59,47,21,43,188,187,153,152,142,341,339,28764,4904262.0,28424,28899.75
6308,51,40,10,30,119,118,93,92,57,212,210,11067,1173102.0,10856,11130.0
6309,111,93,25,58,252,251,264,263,709,516,514,66528,17164224.0,66013,66306.0
631,47,35,12,30,104,103,109,108,56,213,211,11336,1207284.0,11124,11235.75
6310,57,45,18,39,137,136,112,111,85,249,247,15344,1910328.0,15096,15375.75
6311,45,31,10,26,250,249,240,239,570,490,488,60000,14700000.0,59511,59780.0
6312,78,63,23,49,196,195,156,155,186,352,350,30576,5381376.0,30225,30800.0
6314,59,44,14,41,197,196,170,169,218,367,365,33490,6145415.0,33124,33488.75
6315,23,18,8,14,142,141,100,99,79,242,240,14200,1718200.0,13959,14520.0
6316,35,27,10,22,102,101,85,84,39,187,185,8670,810645.0,8484,8648.75
6317,43,29,14,36,220,219,118,117,190,338,336,25960,4387240.0,25623,28392.0
6318,72,57,21,45,209,208,280,279,640,489,487,58520,14308140.0,58032,59535.75
6319,31,24,9,16,83,82,87,86,26,170,168,7221,613785.0,7052,7140.0
632,46,42,14,19,222,221,251,250,442,473,471,55722,13178253.0,55250,55695.75
6320,87,77,27,45,158,157,213,212,218,371,369,33654,6242817.0,33284,34224.75
6321,21,17,6,9,114,113,140,139,81,254,252,15960,2026920.0,15707,16002.0
6322,50,41,16,26,140,139,148,147,117,288,286,20720,2983680.0,20433,20592.0
6323,57,49,13,24,158,157,122,121,101,280,278,19276,2698640.0,18997,19460.0
6324,70,62,20,33,142,141,196,195,159,338,336,27832,4703608.0,27495,28392.0
6325,56,45,16,36,135,134,93,92,63,228,226,12555,1431270.0,12328,12882.0
6326,45,39,10,18,150,149,87,86,59,237,235,13050,1546425.0,12814,13923.75
6327,51,42,13,29,87,86,130,129,52,217,215,11310,1227135.0,11094,11663.75
6328,44,43,13,13,199,198,256,255,450,455,453,50944,11589760.0,50490,51528.75
6329,69,60,24,40,210,209,222,221,285,432,430,46620,10069920.0,46189,46440.0
633,108,91,37,66,336,335,312,311,2348,648,646,104832,33965568.0,104185,104652.0
6330,22,20,8,9,78,77,176,175,75,254,252,13728,1743456.0,13475,16002.0
6331,32,25,5,16,142,141,80,79,102,222,220,11360,1260960.0,11139,12210.0
6332,54,45,14,29,119,118,135,134,112,254,252,16065,2040255.0,15812,16002.0
6333,53,46,22,34,155,154,301,300,331,456,454,46655,10637340.0,46200,51756.0
6334,36,31,9,14,118,117,135,134,135,253,251,15930,2015145.0,15678,15875.75
6335,157,132,56,104,380,379,366,365,1568,746,744,139080,51876840.0,138335,138756.0
6336,114,89,34,82,269,268,298,297,699,567,565,80162,22725927.0,79596,80088.75
6337,39,33,11,20,118,117,196,195,151,314,312,23128,3631096.0,22815,24492.0
6338,51,40,13,31,194,193,146,145,222,340,338,28324,4815080.0,27985,28730.0
6339,56,50,13,23,86,85,134,133,52,220,218,11524,1267640.0,11305,11990.0
634,42,39,14,16,172,171,145,144,143,317,315,24940,3952990.0,24624,24963.75
6340,135,114,47,86,395,394,443,442,2343,838,836,174985,73318715.0,174148,175142.0
6341,77,70,22,32,146,145,212,211,376,358,356,30952,5540408.0,30595,31862.0
6342,45,39,15,24,129,128,88,87,63,217,215,11352,1231692.0,11136,11663.75
6343,48,44,10,15,240,239,154,153,227,394,392,36960,7281120.0,36567,38612.0
6344,67,61,14,24,101,100,124,123,67,225,223,12524,1408950.0,12300,12543.75
6345,46,40,16,25,97,96,145,144,75,242,240,14065,1701865.0,13824,14520.0
6347,45,39,12,18,152,151,92,91,64,244,242,13984,1706048.0,13741,14762.0
6348,56,38,18,52,202,201,150,149,230,352,350,30300,5332800.0,29949,30800.0
6349,60,45,15,36,130,129,133,132,101,263,261,17290,2273635.0,17028,17160.75
635,60,46,24,50,217,216,157,156,221,374,372,34069,6370903.0,33696,34782.0
6351,46,42,11,17,113,112,246,245,207,359,357,27798,4989741.0,27440,32040.75
6352,58,51,16,27,128,127,115,114,72,243,241,14720,1788480.0,14478,14640.75
6353,39,27,10,32,82,81,103,102,47,185,183,8446,781255.0,8262,8463.75
6354,63,43,17,50,219,218,135,134,191,354,352,29565,5233005.0,29212,31152.0
6355,88,70,27,61,183,182,242,241,262,425,423,44286,9410775.0,43862,44943.75
6356,108,93,18,46,187,186,178,177,286,365,363,33286,6074695.0,32922,33123.75
6357,28,27,8,8,141,140,87,86,47,228,226,12267,1398438.0,12040,12882.0
6359,117,92,48,96,309,308,398,397,1237,707,705,122982,43474137.0,122276,124608.75
636,49,44,11,19,222,221,162,161,264,384,382,35964,6905088.0,35581,36672.0
6360,53,48,14,22,157,156,167,166,203,324,322,26219,4247478.0,25896,26082.0
6361,64,55,25,39,206,205,180,179,237,386,384,37080,7156440.0,36695,37056.0
6362,53,48,8,16,106,105,95,94,44,201,199,10070,1012035.0,9870,9999.75
6364,30,27,8,11,106,105,82,81,42,188,186,8692,817048.0,8505,8742.0
6365,36,35,7,7,85,84,119,118,45,204,202,10115,1031730.0,9912,10302.0
6366,68,55,21,44,151,150,175,174,144,326,324,26425,4307275.0,26100,26406.0
6367,59,44,20,46,160,159,284,283,385,444,442,45440,10087680.0,44997,49062.0
6368,60,54,14,24,162,161,137,136,133,299,297,22194,3318003.0,21896,22200.75
6369,91,77,34,58,435,434,288,287,1655,723,721,125280,45288720.0,124558,130320.75
637,81,73,26,39,224,223,207,206,338,431,429,46368,9992304.0,45938,46224.75
6370,50,42,12,22,194,193,105,104,88,299,297,20370,3045315.0,20072,22200.75
6371,36,25,16,35,362,361,214,213,570,576,574,77468,22310784.0,76893,82656.0
6372,76,67,24,40,157,156,158,157,180,315,313,24806,3906945.0,24492,24648.75
6373,83,74,26,42,152,151,167,166,154,319,317,25384,4048748.0,25066,25280.75
6374,75,58,25,51,129,128,123,122,85,252,250,15867,1999242.0,15616,15750.0
6375,54,38,16,45,122,121,178,177,158,300,298,21716,3257400.0,21417,22350.0
6376,58,47,18,38,133,132,145,144,123,278,276,19285,2680615.0,19008,19182.0
6377,48,39,13,29,121,120,103,102,58,224,222,12463,1395856.0,12240,12432.0
6378,85,73,22,43,263,262,167,166,414,430,428,43921,9443015.0,43492,46010.0
638,89,66,28,71,222,221,218,217,657,440,438,48396,10647120.0,47957,48180.0
6380,43,30,11,26,126,125,187,186,177,313,311,23562,3687453.0,23250,24335.75
6381,103,81,27,69,267,266,166,165,372,433,431,44322,9595713.0,43890,46655.75
6382,55,22,9,71,154,153,183,182,229,337,335,28182,4748667.0,27846,28223.75
6383,79,67,20,42,180,179,142,141,145,322,320,25560,4115160.0,25239,25760.0
6384,38,35,10,13,159,158,104,103,81,263,261,16536,2174484.0,16274,17160.75
6386,42,35,13,24,102,101,164,163,86,266,264,16728,2224824.0,16463,17556.0
6387,61,53,24,38,178,177,161,160,159,339,337,28658,4857531.0,28320,28560.75
6388,30,28,10,11,205,204,197,196,277,402,400,40385,8117385.0,39984,40200.0
6389,30,22,10,21,191,190,93,92,81,284,282,17763,2522346.0,17480,20022.0
639,78,71,13,21,106,105,168,167,137,274,272,17808,2439696.0,17535,18632.0
6390,31,25,11,21,432,431,255,254,1062,687,685,110160,37839960.0,109474,117648.75
6391,91,72,31,64,301,300,321,320,1174,622,620,96621,30049131.0,96000,96410.0
6392,57,54,15,19,125,124,111,110,74,236,234,13875,1637250.0,13640,13806.0
6393,67,61,13,19,155,154,110,109,78,265,263,17050,2259125.0,16786,17423.75
6394,50,37,16,40,161,160,105,104,91,266,264,16905,2248365.0,16640,17556.0
6395,77,70,25,37,204,203,239,238,263,443,441,48756,10799454.0,48314,48840.75
6396,35,28,11,18,135,134,142,141,136,277,275,19170,2655045.0,18894,19043.75
6397,165,148,32,64,261,260,330,329,1087,591,589,86130,25451415.0,85540,87024.75
6398,59,50,15,31,120,119,196,195,150,316,314,23520,3716160.0,23205,24806.0
6399,93,84,27,43,352,351,271,270,1154,623,621,95392,29714608.0,94770,96720.75
64,49,42,22,34,316,315,349,348,928,665,663,110284,36669430.0,109620,110223.75
640,39,27,9,31,115,114,93,92,48,208,206,10695,1112280.0,10488,10712.0
6400,38,30,14,26,148,147,229,228,313,377,375,33892,6388642.0,33516,35343.75
6401,48,39,15,30,151,150,218,217,283,369,367,32918,6073371.0,32550,33855.75
6402,78,71,16,28,164,163,131,130,172,295,293,21484,3168890.0,21190,21608.75
6403,65,51,28,54,455,454,288,287,1591,743,741,131040,48681360.0,130298,137640.75
6404,81,64,29,61,237,236,372,371,650,609,607,88164,26845938.0,87556,92415.75
6405,91,76,26,54,210,209,168,167,259,378,376,35280,6667920.0,34903,35532.0
6406,31,22,6,14,208,207,145,144,243,353,351,30160,5323240.0,29808,30975.75
6407,42,37,14,20,142,141,99,98,89,241,239,14058,1693989.0,13818,14399.75
6408,65,55,18,36,209,208,164,163,250,373,371,34276,6392474.0,33904,34595.75
6409,92,70,29,70,213,212,193,192,453,406,404,41109,8345127.0,40704,41006.0
641,98,84,27,51,169,168,157,156,178,326,324,26533,4324879.0,26208,26406.0
6410,34,23,9,28,124,123,218,217,213,342,340,27032,4622472.0,26691,29070.0
6411,54,51,11,15,117,116,78,77,55,195,193,9126,889785.0,8932,9408.75
6412,42,23,8,32,388,387,460,459,4669,848,846,178480,75675520.0,177633,179352.0
6413,70,60,18,34,252,251,150,149,255,402,400,37800,7597800.0,37399,40200.0
6414,89,72,26,57,172,171,181,180,195,353,351,31132,5494798.0,30780,30975.75
6415,49,36,9,26,129,128,240,239,195,369,367,30960,5712120.0,30592,33855.75
6416,66,59,23,34,166,165,161,160,179,327,325,26726,4369701.0,26400,26568.75
6417,40,33,13,25,344,343,272,271,743,616,614,93568,28818944.0,92953,94556.0
6418,55,45,14,30,117,116,155,154,116,272,270,18135,2466360.0,17864,18360.0
6419,74,62,30,52,153,152,194,193,220,347,345,29682,5149827.0,29336,29928.75
642,31,22,11,27,267,266,138,137,333,405,403,36846,7461315.0,36442,40803.75
6420,30,26,11,15,152,151,162,161,167,314,312,24624,3865968.0,24311,24492.0
6421,81,68,23,47,242,241,188,187,328,430,428,45496,9781640.0,45067,46010.0
6422,57,49,16,30,138,137,139,138,122,277,275,19182,2656707.0,18906,19043.75
6424,98,79,39,74,268,267,227,226,814,495,493,60836,15056910.0,60342,61008.75
6425,47,41,16,26,102,101,151,150,88,253,251,15402,1948353.0,15150,15875.75
6426,68,50,18,49,310,309,277,276,1030,587,585,85870,25202845.0,85284,85848.75
6427,77,64,20,42,162,161,193,192,237,355,353,31266,5549715.0,30912,31328.75
6428,109,102,26,38,190,189,155,154,206,345,343,29450,5080125.0,29106,29583.75
6429,63,54,18,33,170,169,150,149,147,320,318,25500,4080000.0,25181,25440.0
643,51,41,14,31,176,175,195,194,201,371,369,34320,6366360.0,33950,34224.75
6430,50,43,18,29,137,136,149,148,164,286,284,20413,2919059.0,20128,20306.0
6431,65,51,20,46,134,133,120,119,96,254,252,16080,2042160.0,15827,16002.0
6432,49,39,22,37,151,150,194,193,234,345,343,29294,5053215.0,28950,29583.75
6433,60,48,19,41,134,133,220,219,199,354,352,29480,5217960.0,29127,31152.0
6434,79,62,28,59,241,240,158,157,348,399,397,38078,7596561.0,37680,39600.75
6435,35,31,15,21,322,321,264,263,690,586,584,85008,24907344.0,84423,85556.0
6436,115,100,26,54,193,192,329,328,475,522,520,63497,16572717.0,62976,67860.0
6437,47,37,20,37,152,151,168,167,111,320,318,25536,4085760.0,25217,25440.0
6438,85,74,27,47,195,194,151,150,148,346,344,29445,5093985.0,29100,29756.0
6439,46,39,15,24,241,240,165,164,264,406,404,39765,8072295.0,39360,41006.0
644,65,56,12,24,102,101,105,104,45,207,205,10710,1108485.0,10504,10608.75
6440,65,61,21,27,174,173,148,147,132,322,320,25752,4146072.0,25431,25760.0
6441,62,52,25,40,179,178,170,169,238,349,347,30430,5310035.0,30082,30275.75
6442,32,30,6,8,101,100,128,127,66,229,227,12928,1480256.0,12700,12995.75
6443,73,54,23,58,163,162,220,219,251,383,381,35860,6867190.0,35478,36480.75
6444,23,20,8,12,81,80,88,87,27,169,167,7128,602316.0,6960,7055.75
6445,61,51,19,37,158,157,135,134,107,293,291,21330,3124845.0,21038,21315.75
6446,60,53,21,31,180,179,185,184,171,365,363,33300,6077250.0,32936,33123.75
6447,53,47,14,22,152,151,215,214,237,367,365,32680,5996780.0,32314,33488.75
6448,25,18,7,17,113,112,154,153,106,267,265,17402,2323167.0,17136,17688.75
6449,66,61,20,27,188,187,196,195,241,384,382,36848,7074816.0,36465,36672.0
645,18,15,5,9,163,162,261,260,245,424,422,42543,9019116.0,42120,44732.0
6450,57,42,18,39,129,128,173,172,152,302,300,22317,3369867.0,22016,22650.0
6451,57,46,22,40,183,182,111,110,128,294,292,20313,2986011.0,20020,21462.0
6452,43,37,12,20,123,122,130,129,90,253,251,15990,2022735.0,15738,15875.75
6453,55,49,19,29,148,147,239,238,214,387,385,35372,6844482.0,34986,37248.75
6454,52,42,16,31,140,139,196,195,146,336,334,27440,4609920.0,27105,28056.0
6455,41,34,14,26,147,146,132,131,103,279,277,19404,2706858.0,19126,19320.75
6456,103,92,28,48,391,390,208,207,1031,599,597,81328,24357736.0,80730,89400.75
6457,66,57,22,38,232,231,169,168,272,401,399,39208,7861204.0,38808,39999.75
6458,49,40,16,27,171,170,124,123,130,295,293,21204,3127590.0,20910,21608.75
646,35,24,9,20,167,166,131,130,142,298,296,21877,3259673.0,21580,22052.0
6460,70,59,21,41,267,266,172,171,419,439,437,45924,10080318.0,45486,47960.75
6461,66,54,18,37,366,365,321,320,2458,687,685,117486,40356441.0,116800,117648.75
6462,42,37,13,20,120,119,119,118,85,239,237,14280,1706460.0,14042,14160.75
6463,52,35,12,43,110,109,134,133,78,244,242,14740,1798280.0,14497,14762.0
6464,68,59,22,38,115,114,298,297,252,413,411,34270,7076755.0,33858,42435.75
6465,36,30,11,21,137,136,104,103,56,241,239,14248,1716884.0,14008,14399.75
6466,25,22,9,13,255,254,106,105,141,361,359,27030,4878915.0,26670,32399.75
6467,84,73,24,43,156,155,212,211,207,368,366,33072,6085248.0,32705,33672.0
6468,72,57,23,51,142,141,156,155,124,298,296,22152,3300648.0,21855,22052.0
6469,139,136,8,12,147,146,147,146,112,294,292,21609,3176523.0,21316,21462.0
647,59,47,15,37,189,188,149,148,234,338,336,28161,4759209.0,27824,28392.0
6470,42,37,14,21,161,160,135,134,173,296,294,21735,3216780.0,21440,21756.0
6471,26,23,8,10,126,125,107,106,73,233,231,13482,1570653.0,13250,13455.75
6472,38,33,14,22,180,179,102,101,109,282,280,18360,2588760.0,18079,19740.0
6473,53,46,14,26,127,126,100,99,61,227,225,12700,1441450.0,12474,12768.75
6474,92,78,29,54,184,183,207,206,242,391,389,38088,7446204.0,37698,38024.75
6475,71,65,20,29,172,171,108,107,101,280,278,18576,2600640.0,18297,19460.0
6476,78,59,23,59,153,152,262,261,337,415,413,40086,8317845.0,39672,42848.75
6477,45,37,10,24,90,89,81,80,31,171,169,7290,623295.0,7120,7224.75
6478,49,44,11,19,102,101,155,154,71,257,255,15810,2031585.0,15554,16383.75
6479,38,34,15,21,101,100,267,266,230,368,366,26967,4961928.0,26600,33672.0
648,49,44,17,24,216,215,227,226,422,443,441,49032,10860588.0,48590,48840.75
6480,60,48,16,37,131,130,168,167,189,299,297,22008,3290196.0,21710,22200.75
6481,38,32,11,19,321,320,229,228,1073,550,548,73509,20214975.0,72960,75350.0
6482,115,91,39,84,368,367,269,268,963,637,635,98992,31528952.0,98356,101123.75
6483,48,37,15,33,163,162,138,137,128,301,299,22494,3385347.0,22194,22499.75
6484,63,53,18,35,178,177,154,153,144,332,330,27412,4550392.0,27081,27390.0
6485,87,65,25,67,241,240,175,174,320,416,414,42175,8772400.0,41760,43056.0
6486,40,32,15,29,172,171,224,223,276,396,394,38528,7628544.0,38133,39006.0
6487,83,67,21,51,294,293,210,209,400,504,502,61740,15558480.0,61237,63252.0
6488,60,47,13,37,139,138,108,107,97,247,245,15012,1853982.0,14766,15128.75
6489,57,48,14,29,107,106,108,107,55,215,213,11556,1242270.0,11342,11448.75
649,103,92,29,49,331,330,171,170,344,502,500,56601,14206851.0,56100,62750.0
6490,129,106,41,83,278,277,319,318,757,597,595,88682,26471577.0,88086,88803.75
6491,66,61,18,25,134,133,107,106,67,241,239,14338,1727729.0,14098,14399.75
6492,50,46,13,19,119,118,209,208,158,328,326,24871,4078844.0,24544,26732.0
6493,60,54,16,24,113,112,134,133,73,247,245,15142,1870037.0,14896,15128.75
6494,48,37,14,34,141,140,170,169,171,311,309,23970,3727335.0,23660,24024.75
6495,107,96,19,36,159,158,202,201,189,361,359,32118,5797299.0,31758,32399.75
6496,44,33,14,27,95,94,195,194,143,290,288,18525,2686125.0,18236,20880.0
6497,59,46,20,44,202,201,231,230,379,433,431,46662,10102323.0,46230,46655.75
6498,138,137,10,10,147,146,285,284,313,432,430,41895,9049320.0,41464,46440.0
6499,53,46,14,25,136,135,146,145,100,282,280,19856,2799696.0,19575,19740.0
65,59,49,18,36,225,224,119,118,136,344,342,26775,4605300.0,26432,29412.0
650,122,115,12,23,170,169,178,177,198,348,346,30260,5265240.0,29913,30102.0
6500,65,52,22,44,158,157,127,126,128,285,283,20066,2859405.0,19782,20163.75
6501,97,70,23,73,276,275,171,170,457,447,445,47196,10548306.0,46750,49728.75
6502,84,76,35,48,267,266,279,278,702,546,544,74493,20336589.0,73948,74256.0
6503,66,57,18,34,108,107,220,219,133,328,326,23760,3896640.0,23433,26732.0
6504,46,36,11,28,102,101,104,103,62,206,204,10608,1092624.0,10403,10506.0
6505,54,46,15,29,86,85,129,128,88,215,213,11094,1192605.0,10880,11448.75
6506,49,39,12,29,129,128,133,132,119,262,260,17157,2247567.0,16896,17030.0
6508,144,127,38,70,327,326,349,348,1042,676,674,114123,38573574.0,113448,113906.0
6509,39,34,11,17,146,145,110,109,82,256,254,16060,2055680.0,15805,16256.0
651,113,95,38,71,267,266,318,317,860,585,583,84906,24835005.0,84322,85263.75
6511,76,61,23,51,186,185,161,160,177,347,345,29946,5195631.0,29600,29928.75
6512,32,27,6,12,122,121,99,98,57,221,219,12078,1334619.0,11858,12099.75
6513,24,23,8,8,370,369,185,184,454,555,553,68450,18994875.0,67896,76728.75
6514,122,98,41,86,545,544,293,292,1788,838,836,159685,66908015.0,158848,175142.0
6515,50,40,11,28,156,155,185,184,263,341,339,28860,4920630.0,28520,28899.75
6516,116,115,4,4,124,123,216,215,145,340,338,26784,4553280.0,26445,28730.0
6517,99,82,25,57,221,220,217,216,354,438,436,47957,10502583.0,47520,47742.0
6518,73,64,28,44,228,227,158,157,226,386,384,36024,6952632.0,35639,37056.0
6519,104,87,41,72,413,412,393,392,3503,806,804,162309,65410527.0,161504,162006.0
652,74,68,21,30,204,203,148,147,153,352,350,30192,5313792.0,29841,30800.0
6520,54,48,17,27,151,150,115,114,81,266,264,17365,2309545.0,17100,17556.0
6521,49,39,17,35,241,240,320,319,846,561,559,77120,21632160.0,76560,78399.75
6522,58,53,14,22,110,109,121,120,77,231,229,13310,1537305.0,13080,13224.75
6523,56,48,15,25,147,146,191,190,184,338,336,28077,4745013.0,27740,28392.0
6524,39,32,15,27,203,202,184,183,285,387,385,37352,7227612.0,36966,37248.75
6525,49,43,13,23,112,111,96,95,41,208,206,10752,1118208.0,10545,10712.0
6526,49,44,10,18,90,89,117,116,47,207,205,10530,1089855.0,10324,10608.75
6527,94,84,28,46,229,228,307,306,689,536,534,70303,18841204.0,69768,71556.0
6528,75,61,17,43,139,138,104,103,72,243,241,14456,1756404.0,14214,14640.75
653,70,48,20,62,233,232,340,339,909,573,571,79220,22696530.0,78648,81795.75
6530,44,35,14,29,199,198,147,146,166,346,344,29253,5060769.0,28908,29756.0
6531,54,46,12,22,163,162,163,162,177,326,324,26569,4330747.0,26244,26406.0
6533,57,51,16,24,126,125,153,152,138,279,277,19278,2689281.0,19000,19320.75
6535,89,79,22,39,201,200,170,169,244,371,369,34170,6338535.0,33800,34224.75
6536,37,34,11,14,325,324,357,356,1450,682,680,116025,39564525.0,115344,115940.0
6538,101,85,37,66,358,357,286,285,806,644,642,102388,32968936.0,101745,103362.0
6539,68,55,14,34,190,189,169,168,190,359,357,32110,5763745.0,31752,32040.75
6540,46,38,9,18,97,96,119,118,54,216,214,11543,1246644.0,11328,11556.0
6541,52,40,19,36,217,216,177,176,303,394,392,38409,7566573.0,38016,38612.0
6542,82,69,21,45,155,154,213,212,178,368,366,33015,6074760.0,32648,33672.0
6543,69,56,22,44,178,177,232,231,305,410,408,41296,8465680.0,40887,41820.0
6544,112,95,37,65,326,325,323,322,1725,649,647,105298,34169201.0,104650,104975.75
6545,55,48,19,29,99,98,194,193,112,293,291,19206,2813679.0,18914,21315.75
6546,30,28,12,13,135,134,127,126,90,262,260,17145,2245995.0,16884,17030.0
6547,40,34,9,18,157,156,113,112,104,270,268,17741,2395035.0,17472,18090.0
6548,74,72,15,17,121,120,142,141,119,263,261,17182,2259433.0,16920,17160.75
6549,36,28,13,27,175,174,102,101,87,277,275,17850,2472225.0,17574,19043.75
655,41,31,12,30,191,190,111,110,152,302,300,21201,3201351.0,20900,22650.0
6550,53,44,15,27,154,153,173,172,176,327,325,26642,4355967.0,26316,26568.75
6551,121,97,43,88,299,298,275,274,801,574,572,82225,23598575.0,81652,82082.0
6552,84,73,33,50,240,239,210,209,342,450,448,50400,11340000.0,49951,50400.0
6553,49,36,16,40,178,177,102,101,121,280,278,18156,2541840.0,17877,19460.0
6554,73,62,24,42,192,191,140,139,179,332,330,26880,4462080.0,26549,27390.0
6555,63,49,17,43,272,271,177,176,392,449,447,48144,10808328.0,47696,50175.75
6556,38,31,7,17,76,75,150,149,118,226,224,11400,1288200.0,11175,12656.0
6557,81,60,24,62,136,135,214,213,157,350,348,29104,5093200.0,28755,30450.0
6558,75,66,16,32,206,205,142,141,153,348,346,29252,5089848.0,28905,30102.0
6559,56,46,16,29,178,177,238,237,281,416,414,42364,8811712.0,41949,43056.0
656,95,90,19,27,179,178,181,180,289,360,358,32399,5831820.0,32040,32220.0
6560,46,40,14,20,107,106,136,135,71,243,241,14552,1768068.0,14310,14640.75
6561,25,23,9,11,88,87,206,205,123,294,292,18128,2664816.0,17835,21462.0
6562,61,55,13,20,133,132,151,150,93,284,282,20083,2851786.0,19800,20022.0
6563,21,20,5,5,138,137,102,101,64,240,238,14076,1689120.0,13837,14280.0
6564,83,67,22,50,175,174,167,166,205,342,340,29225,4997475.0,28884,29070.0
6565,98,87,30,50,203,202,161,160,190,364,362,32683,5948306.0,32320,32942.0
6566,160,127,53,117,533,532,375,374,3105,908,906,199875,90743250.0,198968,205662.0
6567,78,66,24,46,214,213,158,157,245,372,370,33812,6289032.0,33441,34410.0
6568,44,36,14,23,140,139,112,111,124,252,250,15680,1975680.0,15429,15750.0
6569,42,34,16,29,129,128,162,161,125,291,289,20898,3040659.0,20608,21024.75
657,69,52,19,50,253,252,209,208,403,462,460,52877,12214587.0,52416,53130.0
6570,55,44,15,34,120,119,130,129,82,250,248,15600,1950000.0,15351,15500.0
6572,44,35,12,22,146,145,151,150,158,297,295,22046,3273831.0,21750,21903.75
6573,70,57,21,45,121,120,159,158,137,280,278,19239,2693460.0,18960,19460.0
6574,21,19,7,8,271,270,166,165,246,437,435,44986,9829441.0,44550,47523.75
6575,27,23,5,10,192,191,138,137,218,330,328,26496,4371840.0,26167,27060.0
6576,73,54,28,62,361,360,391,390,2013,752,750,141151,53072776.0,140400,141000.0
6577,50,41,18,34,144,143,134,133,103,278,276,19296,2682144.0,19019,19182.0
6578,90,73,24,55,222,221,259,258,601,481,479,57498,13828269.0,57018,57599.75
6579,58,49,23,38,242,241,314,313,487,556,554,75988,21124664.0,75433,77006.0
658,60,50,19,36,193,192,134,133,133,327,325,25862,4228437.0,25536,26568.75
6580,24,22,9,11,109,108,171,170,99,280,278,18639,2609460.0,18360,19460.0
6581,38,34,11,17,201,200,102,101,103,303,301,20502,3106053.0,20200,22800.75
6582,67,47,20,58,178,177,150,149,167,328,326,26700,4378800.0,26373,26732.0
6583,34,30,7,12,131,130,86,85,56,217,215,11266,1222361.0,11050,11663.75
6584,86,74,20,37,305,304,221,220,618,526,524,67405,17727515.0,66880,68906.0
6585,64,59,21,29,178,177,284,283,400,462,460,50552,11677512.0,50091,53130.0
6586,64,55,14,28,91,90,149,148,66,240,238,13559,1627080.0,13320,14280.0
6587,125,97,44,90,270,269,416,415,1292,686,684,112320,38525760.0,111635,117306.0
6588,134,103,39,99,342,341,457,456,2726,799,797,156294,62439453.0,155496,159200.75
6589,75,54,23,58,310,309,211,210,650,521,519,65410,17039305.0,64890,67599.75
659,54,50,14,20,258,257,177,176,366,435,433,45666,9932355.0,45232,47088.75
6590,36,32,14,18,189,188,299,298,387,488,486,56511,13788684.0,56024,59292.0
6591,71,58,26,50,264,263,182,181,275,446,444,48048,10714704.0,47603,49506.0
6592,59,54,7,15,81,80,95,94,33,176,174,7695,677160.0,7520,7656.0
6593,51,36,15,42,146,145,191,190,160,337,335,27886,4698791.0,27550,28223.75
6594,185,173,35,57,285,284,399,398,1143,684,682,113715,38890530.0,113032,116622.0
6595,60,51,18,32,134,133,155,154,127,289,287,20770,3001265.0,20482,20735.75
6597,30,26,11,17,167,166,128,127,120,295,293,21376,3152960.0,21082,21608.75
6598,58,52,18,28,109,108,167,166,142,276,274,18203,2512014.0,17928,18906.0
6599,49,41,18,32,144,143,117,116,82,261,259,16848,2198664.0,16588,16899.75
66,70,52,23,54,151,150,242,241,236,393,391,36542,7180503.0,36150,38415.75
660,30,28,9,11,103,102,161,160,114,264,262,16583,2188956.0,16320,17292.0
6600,257,256,10,10,267,266,267,266,572,534,532,71289,19034163.0,70756,71022.0
6602,48,40,14,26,184,183,159,158,176,343,341,29256,5017404.0,28914,29240.75
6603,61,43,17,49,127,126,172,171,127,299,297,21844,3265678.0,21546,22200.75
6604,70,62,17,31,140,139,164,163,117,304,302,22960,3489920.0,22657,22952.0
6605,149,122,47,99,371,370,261,260,1215,632,630,96831,30598596.0,96200,99540.0
6606,54,47,15,27,148,147,167,166,144,315,313,24716,3892770.0,24402,24648.75
6607,63,56,22,31,156,155,349,348,514,505,503,54444,13747110.0,53940,63503.75
6608,157,131,43,92,437,436,504,503,3733,941,939,220248,103626684.0,219308,220899.75
6609,49,42,16,27,264,263,528,527,1769,792,790,139392,55199232.0,138601,156420.0
6610,39,34,11,18,122,121,206,205,144,328,326,25132,4121648.0,24805,26732.0
6611,47,42,13,21,140,139,98,97,72,238,236,13720,1632680.0,13483,14042.0
6612,29,22,6,14,139,138,170,169,151,309,307,23630,3650835.0,23322,23715.75
6613,89,69,29,67,159,158,221,220,278,380,378,35139,6676410.0,34760,35910.0
6614,62,51,16,36,180,179,264,263,354,444,442,47520,10549440.0,47077,49062.0
6615,44,38,14,24,167,166,91,90,83,258,256,15197,1960413.0,14940,16512.0
6616,56,44,10,28,129,128,158,157,132,287,285,20382,2924817.0,20096,20448.75
6617,58,45,17,41,134,133,158,157,132,292,290,21172,3091112.0,20881,21170.0
6618,55,38,21,53,198,197,128,127,195,326,324,25344,4131072.0,25019,26406.0
6619,40,37,10,13,204,203,170,169,273,374,372,34680,6485160.0,34307,34782.0
662,50,44,13,23,73,72,129,128,47,202,200,9417,951117.0,9216,10100.0
6620,75,68,22,34,178,177,218,217,267,396,394,38804,7683192.0,38409,39006.0
6621,42,35,14,25,98,97,132,131,66,230,228,12936,1487640.0,12707,13110.0
6622,67,50,18,50,209,208,141,140,203,350,348,29469,5157075.0,29120,30450.0
6623,66,57,17,33,162,161,93,92,133,255,253,15066,1920915.0,14812,16128.75
6624,36,29,10,21,331,330,348,347,2397,679,677,115188,39106326.0,114510,114920.75
6625,63,53,16,33,127,126,110,109,74,237,235,13970,1655445.0,13734,13923.75
6626,69,57,17,34,220,219,122,121,169,342,340,26840,4589640.0,26499,29070.0
6627,41,29,14,35,215,214,232,231,414,447,445,49880,11148180.0,49434,49728.75
6628,38,31,14,21,148,147,170,169,129,318,316,25160,4000440.0,24843,25122.0
6629,77,67,26,42,226,225,156,155,292,382,380,35256,6733896.0,34875,36290.0
663,38,31,12,24,122,121,178,177,125,300,298,21716,3257400.0,21417,22350.0
6630,52,44,14,26,176,175,122,121,157,298,296,21472,3199328.0,21175,22052.0
6631,158,121,53,123,436,435,303,302,1806,739,737,132108,48813906.0,131370,136160.75
6632,60,51,16,32,159,158,98,97,92,257,255,15582,2002287.0,15326,16383.75
6633,96,87,22,38,194,193,133,132,173,327,325,25802,4218627.0,25476,26568.75
6634,92,74,33,67,148,147,206,205,254,354,352,30488,5396376.0,30135,31152.0
6635,51,39,14,36,91,90,119,118,62,210,208,10829,1137045.0,10620,10920.0
6636,47,40,19,30,165,164,90,89,69,255,253,14850,1893375.0,14596,16128.75
6637,37,31,11,19,149,148,182,181,223,331,329,27118,4488029.0,26788,27224.75
6638,75,63,20,41,172,171,151,150,135,323,321,25972,4194478.0,25650,25920.75
6639,46,39,14,26,84,83,102,101,37,186,184,8568,796824.0,8383,8556.0
664,29,26,9,13,204,203,106,105,116,310,308,21624,3351720.0,21315,23870.0
6640,64,54,19,37,146,145,166,165,177,312,310,24236,3780816.0,23925,24180.0
6641,60,52,16,29,159,158,149,148,157,308,306,23691,3648414.0,23384,23562.0
6642,38,33,10,18,120,119,101,100,69,221,219,12120,1339260.0,11900,12099.75
6644,67,56,18,35,195,194,150,149,219,345,343,29250,5045625.0,28906,29583.75
6645,64,56,15,29,216,215,101,100,112,317,315,21816,3457836.0,21500,24963.75
6646,61,55,14,22,119,118,170,169,100,289,287,20230,2923235.0,19942,20735.75
6647,69,58,22,41,178,177,148,147,183,326,324,26344,4294072.0,26019,26406.0
6648,62,53,22,38,176,175,170,169,215,346,344,29920,5176160.0,29575,29756.0
6649,50,45,10,18,101,100,150,149,88,251,249,15150,1901325.0,14900,15624.75
665,47,41,13,21,174,173,177,176,217,351,349,30798,5405049.0,30448,30624.75
6650,67,62,17,24,301,300,340,339,1036,641,639,102340,32799970.0,101700,102399.75
6651,52,49,17,21,142,141,113,112,173,255,253,16046,2045865.0,15792,16128.75
6652,74,58,20,48,151,150,273,272,402,424,422,41223,8739276.0,40800,44732.0
6653,173,139,58,124,462,461,533,532,6584,995,993,246246,122507385.0,245252,247008.75
6654,40,32,12,25,93,92,170,169,84,263,261,15810,2079015.0,15548,17160.75
6656,78,64,29,55,161,160,156,155,169,317,315,25116,3980886.0,24800,24963.75
6657,42,35,10,22,110,109,106,105,49,216,214,11660,1259280.0,11445,11556.0
6658,100,80,28,64,163,162,231,230,258,394,392,37653,7417641.0,37260,38612.0
6659,54,47,18,30,122,121,151,150,89,273,271,18422,2514603.0,18150,18495.75
666,77,66,15,31,181,180,171,170,236,352,350,30951,5447376.0,30600,30800.0
6660,71,58,21,43,130,129,170,169,109,300,298,22100,3315000.0,21801,22350.0
6661,63,58,15,23,169,168,89,88,81,258,256,15041,1940289.0,14784,16512.0
6662,104,85,34,70,208,207,340,339,761,548,546,70720,19377280.0,70173,74802.0
6663,51,40,17,35,137,136,215,214,263,352,350,29455,5184080.0,29104,30800.0
6664,39,36,13,17,84,83,162,161,63,246,244,13608,1673784.0,13363,15006.0
6665,50,44,12,22,237,236,138,137,177,375,373,32706,6132375.0,32332,34968.75
6666,106,88,27,61,184,183,209,208,277,393,391,38456,7556604.0,38064,38415.75
6667,32,20,5,19,148,147,126,125,119,274,272,18648,2554776.0,18375,18632.0
6668,86,79,12,22,124,123,118,117,91,242,240,14632,1770472.0,14391,14520.0
6669,24,21,5,9,57,56,103,102,23,160,158,5871,469680.0,5712,6320.0
667,44,41,13,17,146,145,220,219,178,366,364,32120,5877960.0,31755,33306.0
6670,59,39,19,55,198,197,253,252,420,451,449,50094,11296197.0,49644,50624.75
6671,38,31,14,26,135,134,166,165,141,301,299,22410,3372705.0,22110,22499.75
6672,71,63,23,37,163,162,280,279,353,443,441,45640,10109260.0,45198,48840.75
6673,36,30,9,16,80,79,128,127,65,208,206,10240,1064960.0,10033,10712.0
6674,355,341,19,45,405,404,377,376,2223,782,780,152685,59699835.0,151904,152490.0
6675,29,26,8,12,142,141,169,168,161,311,309,23998,3731689.0,23688,24024.75
6676,120,103,35,67,246,245,234,233,460,480,478,57564,13815360.0,57085,57360.0
6677,107,84,25,69,249,248,231,230,511,480,478,57519,13804560.0,57040,57360.0
6678,36,31,13,21,99,98,131,130,93,230,228,12969,1491435.0,12740,13110.0
6679,40,34,12,21,98,97,99,98,54,197,195,9702,955647.0,9506,9603.75
668,115,78,34,103,507,506,384,383,2891,891,889,194688,86733504.0,193798,198024.75
6680,158,139,54,90,436,435,530,529,4639,966,964,231080,111611640.0,230115,232806.0
6681,79,68,31,50,177,176,241,240,253,418,416,42657,8915313.0,42240,43472.0
6683,42,38,13,17,161,160,110,109,90,271,269,17710,2399705.0,17440,18224.75
6684,57,50,16,25,125,124,126,125,80,251,249,15750,1976625.0,15500,15624.75
6685,43,37,16,26,103,102,138,137,71,241,239,14214,1712787.0,13974,14399.75
6686,91,66,26,74,188,187,150,149,214,338,336,28200,4765800.0,27863,28392.0
6687,83,72,14,29,202,201,161,160,240,363,361,32522,5902743.0,32160,32760.75
6688,52,43,13,29,111,110,82,81,48,193,191,9102,878343.0,8910,9215.75
669,47,35,14,33,107,106,124,123,64,231,229,13268,1532454.0,13038,13224.75
6690,48,39,14,28,175,174,216,215,249,391,389,37800,7389900.0,37410,38024.75
6691,89,64,35,81,312,311,452,451,1470,764,762,141024,53871168.0,140261,145542.0
6692,69,61,17,30,149,148,128,127,116,277,275,19072,2641472.0,18796,19043.75
6693,21,20,6,6,127,126,256,255,288,383,381,32512,6226048.0,32130,36480.75
6694,43,39,9,13,108,107,144,143,83,252,250,15552,1959552.0,15301,15750.0
6695,129,98,43,102,513,512,335,334,2674,848,846,171855,72866520.0,171008,179352.0
6696,84,74,33,51,230,229,330,329,956,560,558,75900,21252000.0,75341,78120.0
6697,64,51,18,42,140,139,136,135,104,276,274,19040,2627520.0,18765,18906.0
6698,34,31,15,18,267,266,151,150,324,418,416,40317,8426253.0,39900,43472.0
6699,391,383,13,27,405,404,405,404,3116,810,808,164025,66430125.0,163216,163620.0
67,53,45,17,31,254,253,149,148,266,403,401,37846,7625969.0,37444,40400.75
670,64,53,18,38,164,163,183,182,161,347,345,30012,5207082.0,29666,29928.75
6700,95,82,22,44,156,155,210,209,289,366,364,32760,5995080.0,32395,33306.0
6701,131,109,42,84,350,349,329,328,1045,679,677,115150,39093425.0,114472,114920.75
6702,142,123,46,82,370,369,463,462,2409,833,831,171310,71350615.0,170478,173055.75
6703,43,34,14,25,130,129,139,138,93,269,267,18070,2430415.0,17802,17955.75
6704,65,59,21,31,194,193,144,143,192,338,336,27936,4721184.0,27599,28392.0
6705,75,66,18,34,134,133,235,234,228,369,367,31490,5809905.0,31122,33855.75
6706,59,53,17,27,174,173,120,119,133,294,292,20880,3069360.0,20587,21462.0
6707,53,46,18,30,140,139,167,166,148,307,305,23380,3588830.0,23074,23408.75
6708,43,37,12,20,186,185,99,98,104,285,283,18414,2623995.0,18130,20163.75
6709,74,60,20,43,278,277,159,158,305,437,435,44202,9658137.0,43766,47523.75
671,80,62,29,61,234,233,219,218,345,453,451,51246,11607219.0,50794,51075.75
6710,61,55,19,28,173,172,225,224,264,398,396,38925,7746075.0,38528,39402.0
6711,37,32,13,20,142,141,184,183,194,326,324,26128,4258864.0,25803,26406.0
6712,62,50,14,29,186,185,145,144,253,331,329,26970,4463535.0,26640,27224.75
6713,37,33,10,15,98,97,80,79,50,178,176,7840,697760.0,7663,7832.0
6714,125,115,37,54,238,237,333,332,654,571,569,79254,22627017.0,78684,81224.75
6715,48,34,12,37,97,96,114,113,59,211,209,11058,1166619.0,10848,11024.75
6716,52,47,11,18,449,448,364,363,3528,813,811,163436,66436734.0,162624,164835.75
6717,111,91,27,62,275,274,209,208,495,484,482,57475,13908950.0,56992,58322.0
6719,50,42,17,31,107,106,189,188,121,296,294,20223,2993004.0,19928,21756.0
672,78,58,28,65,150,149,178,177,198,328,326,26700,4378800.0,26373,26732.0
6721,95,84,36,56,234,233,349,348,791,583,581,81666,23805639.0,81084,84680.75
6722,54,44,15,32,168,167,132,131,135,300,298,22176,3326400.0,21877,22350.0
6723,87,69,27,59,197,196,221,220,258,418,416,43537,9099233.0,43120,43472.0
6724,60,55,17,25,102,101,155,154,72,257,255,15810,2031585.0,15554,16383.75
6725,65,56,30,45,490,489,379,378,2503,869,867,185710,80690995.0,184842,188355.75
6726,65,54,26,44,141,140,180,179,264,321,319,25380,4073490.0,25060,25599.75
6727,80,70,22,40,269,268,150,149,301,419,417,40350,8453325.0,39932,43680.75
6728,62,53,23,39,142,141,189,188,154,331,329,26838,4441689.0,26508,27224.75
6729,55,48,19,31,189,188,104,103,93,293,291,19656,2879604.0,19364,21315.75
673,63,57,19,29,162,161,96,95,87,258,256,15552,2006208.0,15295,16512.0
6730,86,78,29,41,178,177,172,171,346,350,348,30616,5357800.0,30267,30450.0
6731,52,51,15,15,231,230,186,185,239,417,415,42966,8958411.0,42550,43263.75
6732,43,33,13,30,221,220,179,178,286,400,398,39559,7911800.0,39160,39800.0
6733,72,61,21,41,139,138,267,266,371,406,404,37113,7533939.0,36708,41006.0
6734,98,79,31,66,168,167,216,215,282,384,382,36288,6967296.0,35905,36672.0
6735,16,15,4,4,248,247,309,308,583,557,555,76632,21342012.0,76076,77283.75
6736,71,65,22,32,149,148,127,126,141,276,274,18923,2611374.0,18648,18906.0
6737,83,69,28,53,282,281,214,213,343,496,494,60348,14966304.0,59853,61256.0
6738,59,50,18,32,129,128,229,228,231,358,356,29541,5287839.0,29184,31862.0
6739,43,36,16,24,373,372,269,268,1040,642,640,100337,32208177.0,99696,102720.0
674,24,21,7,9,133,132,80,79,47,213,211,10640,1133160.0,10428,11235.75
6741,52,41,12,32,131,130,131,130,82,262,260,17161,2248091.0,16900,17030.0
6743,82,69,19,40,145,144,155,154,109,300,298,22475,3371250.0,22176,22350.0
6744,63,52,16,36,143,142,151,150,142,294,292,21593,3174171.0,21300,21462.0
6745,42,38,8,14,115,114,105,104,55,220,218,12075,1328250.0,11856,11990.0
6746,83,73,30,48,181,180,151,150,189,332,330,27331,4536946.0,27000,27390.0
6747,85,61,24,69,167,166,199,198,275,366,364,33233,6081639.0,32868,33306.0
6748,91,77,28,54,267,266,201,200,448,468,466,53667,12558078.0,53200,54522.0
6749,47,33,15,40,141,140,137,136,130,278,276,19317,2685063.0,19040,19182.0
675,52,45,15,26,157,156,111,110,134,268,266,17427,2335218.0,17160,17822.0
6750,24,23,1,1,100,99,90,89,40,190,188,9000,855000.0,8811,8930.0
6751,58,51,13,24,102,101,118,117,66,220,218,12036,1323960.0,11817,11990.0
6752,48,40,17,31,167,166,185,184,170,352,350,30895,5437520.0,30544,30800.0
6753,65,53,17,30,136,135,199,198,167,335,333,27064,4533220.0,26730,27888.75
6754,53,45,18,30,289,288,259,258,767,548,546,74851,20509174.0,74304,74802.0
6755,43,32,10,29,173,172,105,104,101,278,276,18165,2524935.0,17888,19182.0
6757,52,43,15,26,127,126,165,164,129,292,290,20955,3059430.0,20664,21170.0
6758,51,44,13,19,111,110,102,101,57,213,211,11322,1205793.0,11110,11235.75
6759,68,56,24,46,436,435,258,257,966,694,692,112488,39033336.0,111795,120062.0
676,59,53,18,28,265,264,323,322,845,588,586,85595,25164930.0,85008,86142.0
6760,84,71,21,45,151,150,183,182,155,334,332,27633,4614711.0,27300,27722.0
6761,52,37,19,46,203,202,139,138,198,342,340,28217,4825107.0,27876,29070.0
6762,42,37,13,21,132,131,90,89,63,222,220,11880,1318680.0,11659,12210.0
6763,70,63,22,33,218,217,131,130,156,349,347,28558,4983371.0,28210,30275.75
6764,69,60,17,33,171,170,154,153,128,325,323,26334,4279275.0,26010,26243.75
6765,27,24,9,13,138,137,268,267,282,406,404,36984,7507752.0,36579,41006.0
6766,81,72,25,41,141,140,211,210,208,352,350,29751,5236176.0,29400,30800.0
6767,55,43,20,41,233,232,144,143,229,377,375,33552,6324552.0,33176,35343.75
6768,65,52,21,44,117,116,150,149,101,267,265,17550,2342925.0,17284,17688.75
6769,34,27,12,23,376,375,212,211,699,588,586,79712,23435328.0,79125,86142.0
677,45,39,9,18,90,89,129,128,73,219,217,11610,1271295.0,11392,11880.75
6770,110,95,25,53,202,201,268,267,539,470,468,54136,12721960.0,53667,54990.0
6773,64,57,17,27,184,183,165,164,262,349,347,30360,5297820.0,30012,30275.75
6774,49,42,13,22,116,115,186,185,192,302,300,21576,3257976.0,21275,22650.0
6775,20,19,4,4,74,73,93,92,32,167,165,6882,574647.0,6716,6888.75
6776,41,35,10,20,129,128,98,97,63,227,225,12642,1434867.0,12416,12768.75
6777,57,47,20,38,162,161,308,307,486,470,468,49896,11725560.0,49427,54990.0
6778,54,47,19,31,136,135,235,234,306,371,369,31960,5928580.0,31590,34224.75
6779,68,55,20,41,139,138,173,172,160,312,310,24047,3751332.0,23736,24180.0
678,46,40,16,25,189,188,131,130,128,320,318,24759,3961440.0,24440,25440.0
6780,67,56,22,41,222,221,181,180,277,403,401,40182,8096673.0,39780,40400.75
6781,52,44,15,28,148,147,109,108,81,257,255,16132,2072962.0,15876,16383.75
6782,50,43,13,22,109,108,89,88,42,198,196,9701,960399.0,9504,9702.0
6783,64,46,19,53,119,118,174,173,167,293,291,20706,3033429.0,20414,21315.75
6784,66,56,22,40,164,163,144,143,154,308,306,23616,3636864.0,23309,23562.0
6785,115,88,31,81,272,271,337,336,894,609,607,91664,27911688.0,91056,92415.75
6786,38,33,8,14,141,140,98,97,68,239,237,13818,1651251.0,13580,14160.75
6787,79,64,20,48,176,175,186,185,241,362,360,32736,5925216.0,32375,32580.0
6788,63,56,14,25,102,101,141,140,88,243,241,14382,1747413.0,14140,14640.75
6789,59,50,20,36,146,145,196,195,154,342,340,28616,4893336.0,28275,29070.0
679,77,64,21,43,141,140,166,165,106,307,305,23406,3592821.0,23100,23408.75
6790,60,51,16,30,144,143,164,163,120,308,306,23616,3636864.0,23309,23562.0
6791,81,73,16,30,267,266,196,195,436,463,461,52332,12114858.0,51870,53360.75
6792,50,39,21,41,349,348,433,432,1633,782,780,151117,59086747.0,150336,152490.0
6793,37,30,12,24,130,129,183,182,149,313,311,23790,3723135.0,23478,24335.75
6794,38,29,9,20,131,130,94,93,54,225,223,12314,1385325.0,12090,12543.75
6795,56,42,15,41,370,369,268,267,901,638,636,99160,31632040.0,98523,101442.0
6796,86,71,25,52,177,176,244,243,322,421,419,43188,9091074.0,42768,44099.75
6797,66,61,22,30,267,266,118,117,252,385,383,31506,6064905.0,31122,36863.75
6798,66,57,24,39,188,187,130,129,183,318,316,24440,3885960.0,24123,25122.0
6799,106,89,27,59,246,245,215,214,441,461,459,52890,12191145.0,52430,52899.75
68,36,32,12,17,293,292,410,409,1152,703,701,120130,42225695.0,119428,123200.75
680,69,59,19,35,175,174,135,134,142,310,308,23625,3661875.0,23316,23870.0
6800,22,21,6,6,144,143,192,191,145,336,334,27648,4644864.0,27313,28056.0
6801,80,73,27,39,214,213,258,257,354,472,470,55212,13030032.0,54741,55460.0
6802,40,33,10,19,138,137,88,87,59,226,224,12144,1372272.0,11919,12656.0
6803,55,48,18,29,300,299,234,233,540,534,532,70200,18743400.0,69667,71022.0
6804,55,45,9,26,124,123,102,101,92,226,224,12648,1429224.0,12423,12656.0
6805,86,76,22,39,147,146,259,258,315,406,404,38073,7728819.0,37668,41006.0
6806,257,256,10,10,267,266,267,266,584,534,532,71289,19034163.0,70756,71022.0
6807,119,102,33,64,168,167,281,280,405,449,447,47208,10598196.0,46760,50175.75
6808,93,71,26,64,206,205,291,290,497,497,495,59946,14896581.0,59450,61503.75
6809,35,32,8,12,178,177,223,222,282,401,399,39694,7958647.0,39294,39999.75
681,46,39,15,26,176,175,120,119,137,296,294,21120,3125760.0,20825,21756.0
6810,26,23,4,7,278,277,223,222,728,501,499,61994,15529497.0,61494,62499.75
6811,72,63,19,35,114,113,136,135,97,250,248,15504,1938000.0,15255,15500.0
6812,47,38,9,24,103,102,168,167,143,271,269,17304,2344692.0,17034,18224.75
6813,92,82,29,46,310,309,231,230,506,541,539,71610,19370505.0,71070,72899.75
6814,52,42,17,35,108,107,131,130,119,239,237,14148,1690686.0,13910,14160.75
6815,54,41,11,26,150,149,146,145,139,296,294,21900,3241200.0,21605,21756.0
6816,50,39,18,38,186,185,202,201,268,388,386,37572,7288968.0,37185,37442.0
6817,57,50,18,30,201,200,114,113,118,315,313,22914,3608955.0,22600,24648.75
6818,121,116,14,22,178,177,147,146,193,325,323,26166,4251975.0,25842,26243.75
6819,30,27,10,14,110,109,121,120,58,231,229,13310,1537305.0,13080,13224.75
682,76,67,17,33,160,159,129,128,110,289,287,20640,2982480.0,20352,20735.75
6820,57,48,19,34,148,147,145,144,133,293,291,21460,3143890.0,21168,21315.75
6821,56,47,14,29,109,108,123,122,64,232,230,13407,1555212.0,13176,13340.0
6822,85,74,27,46,197,196,281,280,389,478,476,55357,13230323.0,54880,56882.0
6823,52,41,14,33,129,128,105,104,80,234,232,13545,1584765.0,13312,13572.0
6824,58,49,14,30,160,159,117,116,136,277,275,18720,2592720.0,18444,19043.75
6825,35,28,5,17,206,205,142,141,256,348,346,29252,5089848.0,28905,30102.0
6826,60,46,23,49,249,248,201,200,468,450,448,50049,11261025.0,49600,50400.0
6827,47,42,14,20,181,180,171,170,250,352,350,30951,5447376.0,30600,30800.0
6828,49,40,15,31,232,231,131,130,167,363,361,30392,5516148.0,30030,32760.75
6829,73,65,21,35,227,226,154,153,220,381,379,34958,6659499.0,34578,36099.75
683,25,21,6,10,124,123,144,143,98,268,266,17856,2392704.0,17589,17822.0
6830,63,45,18,49,171,170,223,222,288,394,392,38133,7512201.0,37740,38612.0
6831,43,34,14,27,218,217,90,89,110,308,306,19620,3021480.0,19313,23562.0
6832,71,56,22,49,289,288,420,419,1937,709,707,121380,43029210.0,120672,125315.75
6833,56,42,20,42,173,172,126,125,129,299,297,21798,3258801.0,21500,22200.75
6834,69,61,26,40,183,182,150,149,163,333,331,27450,4570425.0,27118,27555.75
6835,95,80,34,61,498,497,291,290,1452,789,787,144918,57170151.0,144130,155235.75
6836,42,41,13,13,169,168,113,112,96,282,280,19097,2692677.0,18816,19740.0
6837,126,100,48,97,536,535,512,511,7525,1048,1046,274432,143802368.0,273385,274052.0
6838,29,27,11,12,178,177,305,304,394,483,481,54290,13111035.0,53808,58080.75
6839,65,51,20,46,209,208,145,144,185,354,352,30305,5363985.0,29952,31152.0
684,88,67,29,67,334,333,381,380,1702,715,713,127254,45493305.0,126540,127448.75
6840,22,19,9,12,89,88,132,131,57,221,219,11748,1298154.0,11528,12099.75
6841,358,356,12,14,517,516,367,366,4027,884,882,189739,83864638.0,188856,194922.0
6842,62,47,18,46,130,129,148,147,112,278,276,19240,2674360.0,18963,19182.0
6843,38,33,13,21,120,119,196,195,142,316,314,23520,3716160.0,23205,24806.0
6844,60,49,21,40,153,152,154,153,154,307,305,23562,3616767.0,23256,23408.75
6845,87,74,21,45,290,289,353,352,912,643,641,102370,32911955.0,101728,103040.75
6846,56,49,14,23,150,149,110,109,61,260,258,16500,2145000.0,16241,16770.0
6847,93,84,17,32,257,256,168,167,336,425,423,43176,9174900.0,42752,44943.75
6848,48,40,14,26,303,302,259,258,673,562,560,78477,22052037.0,77916,78680.0
6849,87,77,20,36,144,143,280,279,381,424,422,40320,8547840.0,39897,44732.0
685,81,69,25,47,154,153,115,114,108,269,267,17710,2381995.0,17442,17955.75
6850,67,54,19,41,157,156,279,278,297,436,434,43803,9549054.0,43368,47306.0
6851,25,21,9,14,135,134,137,136,86,272,270,18495,2515320.0,18224,18360.0
6852,50,44,16,25,168,167,129,128,121,297,295,21672,3218292.0,21376,21903.75
6853,37,34,12,16,141,140,181,180,160,322,320,25521,4108881.0,25200,25760.0
6854,53,46,17,28,164,163,96,95,94,260,258,15744,2046720.0,15485,16770.0
6855,50,45,14,22,88,87,88,87,41,176,174,7744,681472.0,7569,7656.0
6856,32,31,7,7,159,158,158,157,151,317,315,25122,3981837.0,24806,24963.75
6857,37,31,12,22,119,118,145,144,141,264,262,17255,2277660.0,16992,17292.0
6858,100,84,35,57,363,362,275,274,1094,638,636,99825,31844175.0,99188,101442.0
686,143,121,40,76,450,449,369,368,1462,819,817,166050,67997475.0,165232,167280.75
6860,45,37,12,26,135,134,132,131,107,267,265,17820,2378970.0,17554,17688.75
6861,45,34,11,31,225,224,158,157,303,383,381,35550,6807825.0,35168,36480.75
6862,51,41,15,25,152,151,95,94,81,247,245,14440,1783340.0,14194,15128.75
6863,59,48,15,27,172,171,267,266,650,439,437,45924,10080318.0,45486,47960.75
6864,81,76,30,38,364,363,188,187,467,552,550,68432,18887232.0,67881,75900.0
6865,114,113,5,5,124,123,124,123,91,248,246,15376,1906624.0,15129,15252.0
6866,62,50,21,38,134,133,147,146,103,281,279,19698,2767569.0,19418,19599.75
6867,50,37,12,36,128,127,92,91,69,220,218,11776,1295360.0,11557,11990.0
6868,103,82,29,69,476,475,260,259,1233,736,734,123760,45543680.0,123025,135056.0
6869,73,53,19,55,143,142,142,141,123,285,283,20306,2893605.0,20022,20163.75
687,157,126,31,89,284,283,267,266,1035,551,549,75828,20890614.0,75278,75624.75
6871,46,43,9,13,107,106,131,130,71,238,236,14017,1668023.0,13780,14042.0
6872,44,36,15,28,143,142,132,131,108,275,273,18876,2595450.0,18602,18768.75
6873,59,53,20,29,171,170,209,208,308,380,378,35739,6790410.0,35360,35910.0
6874,67,56,17,37,145,144,127,126,96,272,270,18415,2504440.0,18144,18360.0
6875,51,49,15,17,118,117,135,134,96,253,251,15930,2015145.0,15678,15875.75
6876,55,48,17,27,117,116,149,148,88,266,264,17433,2318589.0,17168,17556.0
6877,61,50,23,43,224,223,196,195,374,420,418,43904,9219840.0,43485,43890.0
6878,62,51,16,31,234,233,112,111,201,346,344,26208,4533984.0,25863,29756.0
6879,128,103,44,92,416,415,426,425,5876,842,840,177216,74607936.0,176375,176820.0
688,55,47,12,24,95,94,153,152,81,248,246,14535,1802340.0,14288,15252.0
6880,40,33,11,22,120,119,104,103,60,224,222,12480,1397760.0,12257,12432.0
6882,38,33,12,18,151,150,182,181,173,333,331,27482,4575753.0,27150,27555.75
6884,63,49,14,38,239,238,148,147,267,387,385,35372,6844482.0,34986,37248.75
6885,42,38,13,19,180,179,129,128,111,309,307,23220,3587490.0,22912,23715.75
6886,50,46,15,21,184,183,129,128,143,313,311,23736,3714684.0,23424,24335.75
6887,26,22,4,7,190,189,113,112,162,303,301,21470,3252705.0,21168,22800.75
6888,26,22,10,16,155,154,174,173,160,329,327,26970,4436565.0,26642,26895.75
6889,55,45,19,36,151,150,151,150,117,302,300,22801,3442951.0,22500,22650.0
689,48,41,14,24,96,95,134,133,93,230,228,12864,1479360.0,12635,13110.0
6890,57,51,19,29,178,177,185,184,446,363,361,32930,5976795.0,32568,32760.75
6891,121,95,28,72,267,266,210,209,520,477,475,56070,13372695.0,55594,56643.75
6892,66,56,17,33,127,126,115,114,118,242,240,14605,1767205.0,14364,14520.0
6893,47,41,13,23,116,115,130,129,77,246,244,15080,1854840.0,14835,15006.0
6894,140,115,47,95,309,308,429,428,1588,738,736,132561,48915009.0,131824,135792.0
6895,57,51,11,20,154,153,190,189,152,344,342,29260,5032720.0,28917,29412.0
6896,44,38,10,20,183,182,317,316,593,500,498,58011,14502750.0,57512,62250.0
6897,88,57,23,83,175,174,208,207,275,383,381,36400,6970600.0,36018,36480.75
6898,88,77,26,46,407,406,248,247,1026,655,653,100936,33056540.0,100282,106928.75
6899,35,30,12,19,258,257,203,202,481,461,459,52374,12072207.0,51914,52899.75
69,43,38,12,20,220,219,297,296,455,517,515,65340,16890390.0,64824,66563.75
690,49,41,8,16,104,103,167,166,106,271,269,17368,2353364.0,17098,18224.75
6900,41,35,13,21,171,170,138,137,202,309,307,23598,3645891.0,23290,23715.75
6901,25,23,7,9,107,106,185,184,107,292,290,19795,2890070.0,19504,21170.0
6902,55,51,14,20,154,153,116,115,99,270,268,17864,2411640.0,17595,18090.0
6903,66,54,20,41,207,206,285,284,477,492,490,58995,14512770.0,58504,60270.0
6904,77,61,12,42,169,168,113,112,149,282,280,19097,2692677.0,18816,19740.0
6905,25,22,8,11,268,267,191,190,338,459,457,51188,11747646.0,50730,52440.75
6906,125,119,12,21,170,169,178,177,227,348,346,30260,5265240.0,29913,30102.0
6907,117,116,7,7,124,123,170,169,105,294,292,21080,3098760.0,20787,21462.0
6908,56,49,15,24,138,137,252,251,255,390,388,34776,6781320.0,34387,37830.0
6909,80,61,26,62,422,421,315,314,1359,737,735,132930,48984705.0,132194,135423.75
691,83,64,21,56,162,161,210,209,232,372,370,34020,6327720.0,33649,34410.0
6910,71,56,14,41,145,144,129,128,116,274,272,18705,2562585.0,18432,18632.0
6911,89,74,29,54,231,230,169,168,282,400,398,39039,7807800.0,38640,39800.0
6912,53,40,14,36,97,96,113,112,60,210,208,10961,1150905.0,10752,10920.0
6913,67,58,14,30,108,107,108,107,53,216,214,11664,1259712.0,11449,11556.0
6914,54,45,17,33,138,137,157,156,105,295,293,21666,3195735.0,21372,21608.75
6915,31,27,10,14,119,118,111,110,66,230,228,13209,1519035.0,12980,13110.0
6916,27,23,11,15,123,122,228,227,221,351,349,28044,4921722.0,27694,30624.75
6918,97,81,23,50,196,195,152,151,154,348,346,29792,5183808.0,29445,30102.0
6919,155,139,45,75,283,282,299,298,922,582,580,84617,24623547.0,84036,84390.0
692,80,78,17,19,167,166,158,157,164,325,323,26386,4287725.0,26062,26243.75
6920,45,40,13,19,150,149,130,129,104,280,278,19500,2730000.0,19221,19460.0
6921,390,382,14,28,405,404,405,404,3043,810,808,164025,66430125.0,163216,163620.0
6922,47,37,16,34,214,213,289,288,610,503,501,61846,15554269.0,61344,63000.75
6923,44,39,13,20,93,92,152,151,90,245,243,14136,1731660.0,13892,14883.75
6924,76,62,25,51,211,210,230,229,465,441,439,48530,10700865.0,48090,48399.75
6925,64,52,22,43,124,123,129,128,63,253,251,15996,2023494.0,15744,15875.75
6926,72,61,20,34,161,160,130,129,118,291,289,20930,3045315.0,20640,21024.75
6927,38,31,14,26,171,170,134,133,117,305,303,22914,3494385.0,22610,23103.75
6928,71,60,23,43,247,246,163,162,325,410,408,40261,8253505.0,39852,41820.0
6929,57,26,15,75,172,171,201,200,313,373,371,34572,6447678.0,34200,34595.75
693,22,21,3,3,70,69,157,156,59,227,225,10990,1247365.0,10764,12768.75
6930,119,99,34,71,260,259,362,361,1073,622,620,94120,29271320.0,93499,96410.0
6931,93,81,21,43,238,237,132,131,190,370,368,31416,5811960.0,31047,34040.0
6934,58,50,15,28,163,162,218,217,210,381,379,35534,6769227.0,35154,36099.75
6935,35,28,10,20,135,134,116,115,77,251,249,15660,1965330.0,15410,15624.75
6936,31,25,9,18,96,95,180,179,93,276,274,17280,2384640.0,17005,18906.0
6937,69,66,15,19,99,98,173,172,81,272,270,17127,2329272.0,16856,18360.0
6938,25,23,10,11,119,118,106,105,51,225,223,12614,1419075.0,12390,12543.75
6939,69,60,19,35,133,132,145,144,114,278,276,19285,2680615.0,19008,19182.0
694,71,61,27,42,157,156,250,249,241,407,405,39250,7987375.0,38844,41208.75
6940,40,27,12,33,137,136,85,84,75,222,220,11645,1292595.0,11424,12210.0
6941,150,130,27,65,385,384,293,292,1002,678,676,112805,38240895.0,112128,114582.0
6942,56,53,11,15,128,127,81,80,72,209,207,10368,1083456.0,10160,10815.75
6943,46,36,9,25,98,97,184,183,129,282,280,18032,2542512.0,17751,19740.0
6944,42,37,10,17,97,96,214,213,159,311,309,20758,3227869.0,20448,24024.75
6945,39,34,14,20,200,199,154,153,161,354,352,30800,5451600.0,30447,31152.0
6946,62,55,19,31,227,226,170,169,237,397,395,38590,7660115.0,38194,39203.75
6947,65,52,25,49,206,205,329,328,556,535,533,67774,18129545.0,67240,71288.75
6948,63,48,17,44,121,120,156,155,120,277,275,18876,2614326.0,18600,19043.75
6949,34,28,13,23,175,174,188,187,245,363,361,32900,5971350.0,32538,32760.75
695,68,61,20,32,172,171,228,227,304,400,398,39216,7843200.0,38817,39800.0
6950,41,29,14,36,113,112,137,136,74,250,248,15481,1935125.0,15232,15500.0
6951,34,29,10,15,95,94,76,75,36,171,169,7220,617310.0,7050,7224.75
6952,42,40,14,16,136,135,130,129,141,266,264,17680,2351440.0,17415,17556.0
6953,34,29,10,16,179,178,134,133,115,313,311,23986,3753809.0,23674,24335.75
6954,124,99,41,88,259,258,231,230,593,490,488,59829,14658105.0,59340,59780.0
6955,31,28,9,12,287,286,171,170,386,458,456,49077,11238633.0,48620,52212.0
6957,57,47,16,34,163,162,126,125,87,289,287,20538,2967741.0,20250,20735.75
6958,112,85,37,88,434,433,369,368,2299,803,801,160146,64298619.0,159344,160800.75
6959,37,31,13,23,129,128,145,144,102,274,272,18705,2562585.0,18432,18632.0
696,53,43,19,34,171,170,97,96,123,268,266,16587,2222658.0,16320,17822.0
6960,35,26,10,20,96,95,110,109,58,206,204,10560,1087680.0,10355,10506.0
6961,140,116,40,86,449,448,433,432,3647,882,880,194417,85737897.0,193536,194040.0
6962,119,94,31,78,222,221,189,188,325,411,409,41958,8622369.0,41548,42024.75
6963,72,49,23,65,180,179,216,215,296,396,394,38880,7698240.0,38485,39006.0
6964,63,51,20,41,307,306,251,250,741,558,556,77057,21498903.0,76500,77562.0
6965,28,19,6,21,125,124,122,121,111,247,245,15250,1883375.0,15004,15128.75
6966,60,52,17,27,198,197,122,121,171,320,318,24156,3864960.0,23837,25440.0
6968,67,61,17,24,130,129,176,175,133,306,304,22880,3500640.0,22575,23256.0
6969,44,36,12,26,138,137,108,107,75,246,244,14904,1833192.0,14659,15006.0
697,125,95,46,104,259,258,527,526,1908,786,784,136493,53641749.0,135708,154056.0
6970,108,92,34,64,204,203,222,221,252,426,424,45288,9646344.0,44863,45156.0
6971,58,44,16,42,165,164,271,270,491,436,434,44715,9747870.0,44280,47306.0
6972,78,68,26,42,283,282,339,338,703,622,620,95937,29836407.0,95316,96410.0
6973,54,44,20,37,230,229,136,135,166,366,364,31280,5724240.0,30915,33306.0
6974,54,43,17,36,167,166,140,139,131,307,305,23380,3588830.0,23074,23408.75
6975,52,42,13,31,83,82,167,166,87,250,248,13861,1732625.0,13612,15500.0
6976,49,39,19,35,125,124,263,262,285,388,386,32875,6377750.0,32488,37442.0
6977,63,56,17,29,150,149,108,107,117,258,256,16200,2089800.0,15943,16512.0
6978,32,25,10,21,136,135,92,91,103,228,226,12512,1426368.0,12285,12882.0
6979,77,73,21,25,110,109,124,123,82,234,232,13640,1595880.0,13407,13572.0
6980,41,35,14,24,106,105,122,121,65,228,226,12932,1474248.0,12705,12882.0
6981,48,41,14,26,118,117,82,81,34,200,198,9676,967600.0,9477,9900.0
6982,80,67,21,45,267,266,121,120,267,388,386,32307,6267558.0,31920,37442.0
6983,65,57,20,33,309,308,222,221,488,531,529,68598,18212769.0,68068,70224.75
6984,74,66,26,40,254,253,156,155,319,410,408,39624,8122920.0,39215,41820.0
6985,101,89,40,61,370,369,201,200,766,571,569,74370,21232635.0,73800,81224.75
6986,54,49,15,23,168,167,139,138,127,307,305,23352,3584532.0,23046,23408.75
6987,47,42,16,23,257,256,136,135,246,393,391,34952,6868068.0,34560,38415.75
6988,29,20,6,14,200,199,217,216,410,417,415,43400,9048900.0,42984,43263.75
6989,48,40,22,35,235,234,340,339,635,575,573,79900,22971250.0,79326,82368.75
699,46,40,17,27,159,158,147,146,123,306,304,23373,3576069.0,23068,23256.0
6990,50,46,15,20,147,146,150,149,155,297,295,22050,3274425.0,21754,21903.75
6991,51,41,17,34,175,174,138,137,127,313,311,24150,3779475.0,23838,24335.75
6992,68,56,16,37,151,150,148,147,114,299,297,22348,3341026.0,22050,22200.75
6993,66,54,21,40,196,195,173,172,237,369,367,33908,6256026.0,33540,33855.75
6994,56,47,24,40,147,146,141,140,97,288,286,20727,2984688.0,20440,20592.0
6995,55,40,20,47,142,141,169,168,143,311,309,23998,3731689.0,23688,24024.75
6996,74,65,21,36,186,185,123,122,128,309,307,22878,3534651.0,22570,23715.75
6997,57,50,19,31,154,153,105,104,97,259,257,16170,2094015.0,15912,16640.75
6998,85,76,26,42,296,295,390,389,1145,686,684,115440,39595920.0,114755,117306.0
6999,75,64,19,38,131,130,153,152,96,284,282,20043,2846106.0,19760,20022.0
70,43,42,14,14,159,158,273,272,303,432,430,43407,9375912.0,42976,46440.0
700,38,35,13,16,172,171,92,91,93,264,262,15824,2088768.0,15561,17292.0
7000,52,40,17,36,135,134,118,117,98,253,251,15930,2015145.0,15678,15875.75
7001,34,30,8,14,126,125,105,104,68,231,229,13230,1528065.0,13000,13224.75
7002,57,38,14,48,121,120,159,158,129,280,278,19239,2693460.0,18960,19460.0
7003,55,52,15,17,139,138,204,203,197,343,341,28356,4863054.0,28014,29240.75
7004,29,27,9,10,111,110,123,122,68,234,232,13653,1597401.0,13420,13572.0
7005,50,45,17,25,100,99,144,143,71,244,242,14400,1756800.0,14157,14762.0
7006,119,118,6,6,170,169,147,146,134,317,315,24990,3960915.0,24674,24963.75
7007,108,103,11,19,178,177,216,215,351,394,392,38448,7574256.0,38055,38612.0
7008,56,49,18,29,233,232,295,294,564,528,526,68735,18146040.0,68208,69432.0
7009,40,31,14,24,182,181,114,113,92,296,294,20748,3070704.0,20453,21756.0
701,44,40,17,20,232,231,197,196,503,429,427,45704,9803508.0,45276,45795.75
7011,91,75,28,58,292,291,213,212,516,505,503,62196,15704490.0,61692,63503.75
7012,43,38,13,20,174,173,159,158,174,333,331,27666,4606389.0,27334,27555.75
7013,64,58,15,25,227,226,121,120,139,348,346,27467,4779258.0,27120,30102.0
7014,54,42,17,37,202,201,115,114,192,317,315,23230,3681955.0,22914,24963.75
7015,61,44,11,42,122,121,141,140,119,263,261,17202,2262063.0,16940,17160.75
7016,166,139,55,106,328,327,426,425,1762,754,752,139728,52677456.0,138975,141752.0
7017,97,79,29,63,211,210,231,230,324,442,440,48741,10771761.0,48300,48620.0
7018,128,121,14,25,178,177,170,169,212,348,346,30260,5265240.0,29913,30102.0
7019,84,71,32,55,281,280,464,463,1905,745,743,130384,48568040.0,129640,138383.75
702,55,44,13,26,155,154,153,152,160,308,306,23715,3652110.0,23408,23562.0
7020,17,16,4,4,114,113,81,80,38,195,193,9234,900315.0,9040,9408.75
7021,53,45,14,24,155,154,125,124,104,280,278,19375,2712500.0,19096,19460.0
7022,124,110,37,62,247,246,365,364,956,612,610,90155,27587430.0,89544,93330.0
7023,48,42,13,21,100,99,160,159,86,260,258,16000,2080000.0,15741,16770.0
7024,103,85,39,73,464,463,299,298,1465,763,761,138736,52927784.0,137974,145160.75
7025,69,57,22,42,474,473,294,293,1303,768,766,139356,53512704.0,138589,147072.0
7026,59,48,19,38,213,212,142,141,196,355,353,30246,5368665.0,29892,31328.75
7027,76,56,23,61,179,178,191,190,212,370,368,34189,6324965.0,33820,34040.0
7028,41,35,15,25,152,151,77,76,64,229,227,11704,1340108.0,11476,12995.75
7029,97,81,30,59,189,188,180,179,221,369,367,34020,6276690.0,33652,33855.75
7030,34,31,11,15,534,533,291,290,2048,825,823,155394,64100025.0,154570,169743.75
7031,45,38,11,22,237,236,144,143,222,381,379,34128,6501384.0,33748,36099.75
7032,26,23,5,9,191,190,195,194,412,386,384,37245,7188285.0,36860,37056.0
7033,40,36,14,20,241,240,104,103,160,345,343,25064,4323540.0,24720,29583.75
7034,39,36,15,19,141,140,187,186,143,328,326,26367,4324188.0,26040,26732.0
7035,61,47,17,43,146,145,134,133,146,280,278,19564,2738960.0,19285,19460.0
7036,84,74,19,36,146,145,130,129,97,276,274,18980,2619240.0,18705,18906.0
7038,65,56,15,31,215,214,131,130,142,346,344,28165,4872545.0,27820,29756.0
7039,96,80,23,51,240,239,425,424,1194,665,663,102000,33915000.0,101336,110223.75
704,100,80,36,73,352,351,350,349,1252,702,700,123200,43243200.0,122499,122850.0
7040,90,67,29,72,210,209,241,240,418,451,449,50610,11412555.0,50160,50624.75
7041,63,57,20,30,238,237,289,288,562,527,525,68782,18124057.0,68256,69168.75
7042,38,30,10,23,193,192,162,161,195,355,353,31266,5549715.0,30912,31328.75
7043,81,69,31,53,339,338,435,434,1703,774,772,147465,57068955.0,146692,149382.0
7044,46,42,13,19,193,192,124,123,126,317,315,23932,3793222.0,23616,24963.75
7045,108,79,31,87,241,240,243,242,672,484,482,58563,14172246.0,58080,58322.0
7047,60,49,20,39,201,200,231,230,219,432,430,46431,10029096.0,46000,46440.0
7048,52,46,14,23,172,171,88,87,95,260,258,15136,1967680.0,14877,16770.0
7049,41,34,14,26,179,178,120,119,115,299,297,21480,3211260.0,21182,22200.75
705,171,170,7,7,178,177,178,177,177,356,354,31684,5639752.0,31329,31506.0
7050,58,48,21,37,132,131,161,160,207,293,291,21252,3113418.0,20960,21315.75
7051,46,37,12,26,109,108,77,76,40,186,184,8393,780549.0,8208,8556.0
7052,24,22,8,10,185,184,208,207,267,393,391,38480,7561320.0,38088,38415.75
7053,71,57,23,49,125,124,150,149,104,275,273,18750,2578125.0,18476,18768.75
7055,37,34,13,15,336,335,149,148,457,485,483,50064,12140520.0,49580,58563.75
7056,95,78,26,56,294,293,363,362,987,657,655,106722,35058177.0,106066,107583.75
7057,39,36,9,13,297,296,92,91,200,389,387,27324,5314518.0,26936,37635.75
7058,21,20,3,3,152,151,109,108,85,261,259,16568,2162124.0,16308,16899.75
7059,98,77,33,73,237,236,406,405,949,643,641,96222,30935373.0,95580,103040.75
706,64,54,23,40,220,219,318,317,633,538,536,69960,18819240.0,69423,72092.0
7060,62,57,19,27,160,159,150,149,161,310,308,24000,3720000.0,23691,23870.0
7061,90,73,28,60,417,416,369,368,1843,786,784,153873,60472089.0,153088,154056.0
7062,93,77,30,60,171,170,214,213,240,385,383,36594,7044345.0,36210,36863.75
7063,23,20,8,12,227,226,182,181,343,409,407,41314,8448713.0,40906,41615.75
7064,63,56,22,34,118,117,207,206,141,325,323,24426,3969225.0,24102,26243.75
7065,59,52,19,30,123,122,182,181,149,305,303,22386,3413865.0,22082,23103.75
7066,40,38,11,13,147,146,213,212,365,360,358,31311,5635980.0,30952,32220.0
7067,59,51,18,32,146,145,135,134,121,281,279,19710,2769255.0,19430,19599.75
7069,36,28,16,27,129,128,163,162,108,292,290,21027,3069942.0,20736,21170.0
707,56,47,16,28,101,100,104,103,49,205,203,10504,1076660.0,10300,10403.75
7070,43,39,13,19,113,112,171,170,98,284,282,19323,2743866.0,19040,20022.0
7071,32,26,6,14,117,116,169,168,137,286,284,19773,2827539.0,19488,20306.0
7072,92,83,22,38,156,155,257,256,357,413,411,40092,8278998.0,39680,42435.75
7073,37,35,7,8,93,92,77,76,35,170,168,7161,608685.0,6992,7140.0
7074,63,47,17,47,180,179,239,238,301,419,417,43020,9012690.0,42602,43680.75
7075,56,42,17,43,120,119,157,156,138,277,275,18840,2609340.0,18564,19043.75
7076,59,52,17,29,147,146,152,151,144,299,297,22344,3340428.0,22046,22200.75
7077,28,26,9,11,95,94,100,99,38,195,193,9500,926250.0,9306,9408.75
7078,47,37,14,31,301,300,245,244,554,546,544,73745,20132385.0,73200,74256.0
7079,42,35,10,22,141,140,186,185,161,327,325,26226,4287951.0,25900,26568.75
708,102,77,28,73,248,247,267,266,556,515,513,66216,17050620.0,65702,66048.75
7080,68,60,19,32,143,142,240,239,221,383,381,34320,6572280.0,33938,36480.75
7081,49,47,14,16,159,158,129,128,134,288,286,20511,2953584.0,20224,20592.0
7082,25,22,8,12,432,431,281,280,2146,713,711,121392,43276248.0,120680,126735.75
7083,63,54,19,35,190,189,141,140,136,331,329,26790,4433745.0,26460,27224.75
7084,41,38,13,17,96,95,130,129,59,226,224,12480,1410240.0,12255,12656.0
7085,49,39,10,28,345,344,203,202,726,548,546,70035,19189590.0,69488,74802.0
7086,96,87,21,37,205,204,142,141,203,347,345,29110,5050585.0,28764,29928.75
7087,257,256,10,10,267,266,267,266,594,534,532,71289,19034163.0,70756,71022.0
7088,59,38,16,55,189,188,192,191,323,381,379,36288,6912864.0,35908,36099.75
7089,51,36,16,42,340,339,313,312,918,653,651,106420,34746130.0,105768,106275.75
709,85,80,22,30,276,275,126,125,203,402,400,34776,6989976.0,34375,40200.0
7090,74,49,23,68,207,206,267,266,492,474,472,55269,13098753.0,54796,55932.0
7091,35,26,9,23,137,136,104,103,98,241,239,14248,1716884.0,14008,14399.75
7092,70,59,24,44,184,183,143,142,190,327,325,26312,4302012.0,25986,26568.75
7093,36,23,9,33,90,89,137,136,73,227,225,12330,1399455.0,12104,12768.75
7094,53,46,17,28,344,343,272,271,605,616,614,93568,28818944.0,92953,94556.0
7095,68,52,25,55,215,214,300,299,736,515,513,64500,16608750.0,63986,66048.75
7097,45,42,11,15,81,80,139,138,53,220,218,11259,1238490.0,11040,11990.0
7098,22,21,8,8,212,211,93,92,103,305,303,19716,3006690.0,19412,23103.75
71,62,53,20,36,114,113,112,111,68,226,224,12768,1442784.0,12543,12656.0
710,67,43,15,61,142,141,188,187,233,330,328,26696,4404840.0,26367,27060.0
7100,53,45,16,30,107,106,104,103,53,211,209,11128,1174004.0,10918,11024.75
7101,60,49,15,29,162,161,220,219,260,382,380,35640,6807240.0,35259,36290.0
7102,64,45,16,50,122,121,133,132,101,255,253,16226,2068815.0,15972,16128.75
7103,117,101,28,57,251,250,158,157,296,409,407,39658,8110061.0,39250,41615.75
7104,82,67,23,51,192,191,195,194,369,387,385,37440,7244640.0,37054,37248.75
7105,54,48,14,24,113,112,100,99,66,213,211,11300,1203450.0,11088,11235.75
7106,54,50,15,21,137,136,126,125,103,263,261,17262,2269953.0,17000,17160.75
7107,52,44,14,26,169,168,106,105,75,275,273,17914,2463175.0,17640,18768.75
7109,38,30,10,24,90,89,187,186,182,277,275,16830,2330955.0,16554,19043.75
711,47,35,16,36,182,181,182,181,202,364,362,33124,6028568.0,32761,32942.0
7110,46,36,12,26,142,141,239,238,297,381,379,33938,6465189.0,33558,36099.75
7111,40,38,10,12,162,161,168,167,188,330,328,27216,4490640.0,26887,27060.0
7112,49,42,9,18,136,135,97,96,56,233,231,13192,1536868.0,12960,13455.75
7113,112,88,30,76,188,187,196,195,278,384,382,36848,7074816.0,36465,36672.0
7114,55,36,17,52,232,231,169,168,422,401,399,39208,7861204.0,38808,39999.75
7115,92,85,19,31,180,179,144,143,123,324,322,25920,4199040.0,25597,26082.0
7116,53,41,14,36,139,138,212,211,247,351,349,29468,5171634.0,29118,30624.75
7117,132,119,29,51,201,200,250,249,371,451,449,50250,11331375.0,49800,50624.75
7118,69,48,27,66,325,324,243,242,730,568,566,78975,22428900.0,78408,80372.0
7119,51,40,18,38,99,98,161,160,77,260,258,15939,2072070.0,15680,16770.0
7120,68,60,15,27,114,113,156,155,81,270,268,17784,2400840.0,17515,18090.0
7121,53,45,11,25,88,87,94,93,32,182,180,8272,752752.0,8091,8190.0
7122,88,80,28,41,181,180,256,255,348,437,435,46336,10124416.0,45900,47523.75
7123,53,42,15,35,125,124,146,145,155,271,269,18250,2472875.0,17980,18224.75
7124,48,41,17,28,147,146,164,163,192,311,309,24108,3748794.0,23798,24024.75
7125,74,51,20,64,286,285,304,303,1085,590,588,86944,25648480.0,86355,86730.0
7126,59,57,12,14,138,137,145,144,122,283,281,20010,2831415.0,19728,19880.75
7127,38,35,13,17,187,186,170,169,228,357,355,31790,5674515.0,31434,31683.75
7128,52,44,17,26,216,215,124,123,181,340,338,26784,4553280.0,26445,28730.0
7129,257,256,10,10,267,266,267,266,604,534,532,71289,19034163.0,70756,71022.0
713,42,36,19,26,186,185,228,227,309,414,412,42408,8778456.0,41995,42642.0
7130,54,49,10,16,100,99,84,83,28,184,182,8400,772800.0,8217,8372.0
7131,69,53,20,45,183,182,164,163,227,347,345,30012,5207082.0,29666,29928.75
7132,163,162,8,8,262,261,170,169,302,432,430,44540,9620640.0,44109,46440.0
7133,51,38,15,38,280,279,298,297,798,578,576,83440,24114160.0,82863,83232.0
7134,54,46,14,28,126,125,84,83,38,210,208,10584,1111320.0,10375,10920.0
7135,28,23,9,15,152,151,143,142,133,295,293,21736,3206060.0,21442,21608.75
7136,46,40,15,25,119,118,251,250,200,370,368,29869,5525765.0,29500,34040.0
7137,78,67,29,49,234,233,152,151,315,386,384,35568,6864624.0,35183,37056.0
7138,95,79,25,53,183,182,220,219,295,403,401,40260,8112390.0,39858,40400.75
7139,90,76,26,51,208,207,273,272,427,481,479,56784,13656552.0,56304,57599.75
714,76,66,18,35,182,181,127,126,126,309,307,23114,3571113.0,22806,23715.75
7140,91,76,31,59,248,247,271,270,516,519,517,67208,17440476.0,66690,67080.75
7141,79,69,20,37,164,163,245,244,285,409,407,40180,8216810.0,39772,41615.75
7142,80,63,24,54,184,183,267,266,501,451,449,49128,11078364.0,48678,50624.75
7143,98,91,23,35,230,229,129,128,198,359,357,29670,5325765.0,29312,32040.75
7144,33,30,11,15,214,213,191,190,265,405,403,40874,8276985.0,40470,40803.75
7145,55,51,9,14,137,136,81,80,65,218,216,11097,1209573.0,10880,11772.0
7146,54,40,15,41,142,141,105,104,84,247,245,14910,1841385.0,14664,15128.75
7147,82,73,21,37,247,246,184,183,331,431,429,45448,9794044.0,45018,46224.75
7148,31,25,6,12,105,104,121,120,67,226,224,12705,1435665.0,12480,12656.0
7149,74,61,23,46,226,225,155,154,306,381,379,35030,6673215.0,34650,36099.75
715,86,68,34,66,414,413,345,344,1321,759,757,142830,54203985.0,142072,143640.75
7150,59,52,12,24,141,140,135,134,100,276,274,19035,2626830.0,18760,18906.0
7151,66,58,10,19,120,119,205,204,157,325,323,24600,3997500.0,24276,26243.75
7152,86,85,14,14,124,123,207,206,134,331,329,25668,4248054.0,25338,27224.75
7154,86,78,21,33,199,198,165,164,204,364,362,32835,5975970.0,32472,32942.0
7155,69,58,20,38,229,228,247,246,480,476,474,56563,13461994.0,56088,56406.0
7156,24,21,6,10,120,119,124,123,73,244,242,14880,1815360.0,14637,14762.0
7157,32,21,11,27,96,95,130,129,60,226,224,12480,1410240.0,12255,12656.0
7158,140,139,8,8,147,146,285,284,359,432,430,41895,9049320.0,41464,46440.0
7159,101,85,27,57,295,294,259,258,731,554,552,76405,21164185.0,75852,76452.0
716,48,42,14,23,122,121,170,169,108,292,290,20740,3028040.0,20449,21170.0
7160,43,38,11,17,150,149,92,91,81,242,240,13800,1669800.0,13559,14520.0
7161,45,35,15,28,184,183,154,153,146,338,336,28336,4788784.0,27999,28392.0
7162,58,46,14,32,170,169,157,156,145,327,325,26690,4363815.0,26364,26568.75
7163,71,60,23,43,183,182,124,123,114,307,305,22692,3483222.0,22386,23408.75
7164,60,48,18,40,100,99,169,168,108,269,267,16900,2273050.0,16632,17955.75
7165,62,58,17,23,189,188,107,106,122,296,294,20223,2993004.0,19928,21756.0
7166,48,34,12,33,189,188,156,155,173,345,343,29484,5085990.0,29140,29583.75
7167,121,82,28,100,326,325,289,288,983,615,613,94214,28970805.0,93600,94248.75
7168,45,37,13,25,94,93,139,138,72,233,231,13066,1522189.0,12834,13455.75
7169,48,45,11,15,143,142,144,143,99,287,285,20592,2954952.0,20306,20448.75
717,62,57,17,25,138,137,132,131,87,270,268,18216,2459160.0,17947,18090.0
7170,57,52,11,19,104,103,74,73,31,178,176,7696,684944.0,7519,7832.0
7171,25,23,8,9,98,97,115,114,47,213,211,11270,1200255.0,11058,11235.75
7172,46,38,11,25,141,140,111,110,82,252,250,15651,1972026.0,15400,15750.0
7173,61,55,15,24,234,233,117,116,229,351,349,27378,4804839.0,27028,30624.75
7174,56,46,25,42,197,196,186,185,282,383,381,36642,7016943.0,36260,36480.75
7175,76,69,24,36,201,200,166,165,257,367,365,33366,6122661.0,33000,33488.75
7176,31,23,10,21,114,113,125,124,99,239,237,14250,1702875.0,14012,14160.75
7177,45,34,9,25,175,174,95,94,89,270,268,16625,2244375.0,16356,18090.0
7178,51,42,22,38,446,445,161,160,672,607,605,71806,21793121.0,71200,91808.75
7179,53,40,18,41,205,204,105,104,126,310,308,21525,3336375.0,21216,23870.0
718,33,29,12,18,207,206,208,207,446,415,413,43056,8934120.0,42642,42848.75
7180,33,24,8,24,150,149,162,161,157,312,310,24300,3790800.0,23989,24180.0
7181,47,40,15,27,107,106,201,200,151,308,306,21507,3312078.0,21200,23562.0
7182,83,70,36,60,205,204,505,504,937,710,708,103525,36751375.0,102816,125670.0
7183,54,40,19,44,125,124,201,200,184,326,324,25125,4095375.0,24800,26406.0
7184,53,44,17,28,111,110,210,209,188,321,319,23310,3741255.0,22990,25599.75
7185,70,64,19,28,150,149,251,250,252,401,399,37650,7548825.0,37250,39999.75
7186,105,85,24,62,267,266,277,276,722,544,542,73959,20116848.0,73416,73712.0
7187,107,71,28,98,257,256,308,307,1028,565,563,79156,22361570.0,78592,79523.75
7188,46,42,15,21,242,241,132,131,307,374,372,31944,5973528.0,31571,34782.0
7189,100,86,31,57,308,307,343,342,1515,651,649,105644,34387122.0,104994,105624.75
719,134,109,42,90,327,326,408,407,1790,735,733,133416,49030380.0,132682,134688.75
7190,44,37,13,23,193,192,141,140,176,334,332,27213,4544571.0,26880,27722.0
7191,32,30,9,11,83,82,128,127,50,211,209,10624,1120832.0,10414,11024.75
7192,29,27,10,12,85,84,199,198,85,284,282,16915,2401930.0,16632,20022.0
7193,125,110,21,49,183,182,235,234,317,418,416,43005,8988045.0,42588,43472.0
7196,76,67,22,38,161,160,192,191,169,353,351,30912,5455968.0,30560,30975.75
7197,35,30,12,20,188,187,187,186,290,375,373,35156,6591750.0,34782,34968.75
7198,37,32,8,16,105,104,135,134,71,240,238,14175,1701000.0,13936,14280.0
7199,40,29,11,30,165,164,136,135,151,301,299,22440,3377220.0,22140,22499.75
72,67,53,23,49,193,192,210,209,319,403,401,40530,8166795.0,40128,40400.75
720,74,64,21,39,142,141,151,150,109,293,291,21442,3141253.0,21150,21315.75
7200,50,39,14,34,186,185,165,164,183,351,349,30690,5386095.0,30340,30624.75
7201,117,95,32,74,311,310,304,303,863,615,613,94544,29072280.0,93930,94248.75
7202,126,109,36,68,301,300,407,406,1674,708,706,122507,43367478.0,121800,124962.0
7203,57,51,20,28,161,160,103,102,102,264,262,16583,2188956.0,16320,17292.0
7204,68,59,28,42,234,233,217,216,468,451,449,50778,11450439.0,50328,50624.75
7205,26,23,8,11,121,120,203,202,140,324,322,24563,3979206.0,24240,26082.0
7206,38,30,12,25,117,116,84,83,43,201,199,9828,987714.0,9628,9999.75
7207,49,34,18,46,215,214,136,135,169,351,349,29240,5131620.0,28890,30624.75
7209,70,59,22,42,217,216,305,304,634,522,520,66185,17274285.0,65664,67860.0
721,81,73,22,36,171,170,247,246,405,418,416,42237,8827533.0,41820,43472.0
7210,70,60,20,36,143,142,194,193,167,337,335,27742,4674527.0,27406,28223.75
7211,57,54,16,20,212,211,96,95,171,308,306,20352,3134208.0,20045,23562.0
7212,37,30,9,15,239,238,280,279,696,519,517,66920,17365740.0,66402,67080.75
7213,45,40,10,18,98,97,107,106,63,205,203,10486,1074815.0,10282,10403.75
7214,72,68,21,27,209,208,117,116,292,326,324,24453,3985839.0,24128,26406.0
7215,37,28,13,27,227,226,238,237,404,465,463,54026,12561045.0,53562,53823.75
7216,43,35,13,26,131,130,85,84,42,216,214,11135,1202580.0,10920,11556.0
7217,74,57,26,57,201,200,155,154,191,356,354,31155,5545590.0,30800,31506.0
7218,58,52,22,32,209,208,107,106,113,316,314,22363,3533354.0,22048,24806.0
7219,65,60,20,28,110,109,132,131,79,242,240,14520,1756920.0,14279,14520.0
722,65,54,22,42,178,177,160,159,148,338,336,28480,4813120.0,28143,28392.0
7220,81,73,25,39,183,182,241,240,290,424,422,44103,9349836.0,43680,44732.0
7221,51,41,11,29,101,100,129,128,56,230,228,13029,1498335.0,12800,13110.0
7222,27,24,9,13,97,96,108,107,42,205,203,10476,1073790.0,10272,10403.75
7223,35,29,9,16,99,98,117,116,52,216,214,11583,1250964.0,11368,11556.0
7224,84,74,25,43,188,187,320,319,544,508,506,60160,15280640.0,59653,64262.0
7225,65,52,19,41,206,205,147,146,211,353,351,30282,5344773.0,29930,30975.75
7226,78,60,28,61,270,269,333,332,798,603,601,89910,27107865.0,89308,90600.75
7227,55,43,23,45,167,166,233,232,221,400,398,38911,7782200.0,38512,39800.0
7228,46,38,18,31,243,242,153,152,247,396,394,37179,7361442.0,36784,39006.0
7229,391,383,13,27,405,404,405,404,3025,810,808,164025,66430125.0,163216,163620.0
723,27,23,10,15,97,96,344,343,239,441,439,33368,7357644.0,32928,48399.75
7230,53,47,19,29,303,302,189,188,494,492,490,57267,14087682.0,56776,60270.0
7231,41,36,12,19,129,128,146,145,97,275,273,18834,2589675.0,18560,18768.75
7232,56,52,15,21,157,156,155,154,151,312,310,24335,3796260.0,24024,24180.0
7233,45,35,16,34,143,142,124,123,81,267,265,17732,2367222.0,17466,17688.75
7234,37,30,9,21,72,71,156,155,64,228,226,11232,1280448.0,11005,12882.0
7235,55,37,16,50,169,168,129,128,181,298,296,21801,3248349.0,21504,22052.0
7236,34,25,9,25,144,143,159,158,141,303,301,22896,3468744.0,22594,22800.75
7237,38,33,8,16,90,89,83,82,36,173,171,7470,646155.0,7298,7395.75
7238,96,84,24,46,167,166,171,170,225,338,336,28557,4826133.0,28220,28392.0
7239,54,52,9,11,111,110,147,146,76,258,256,16317,2104893.0,16060,16512.0
724,58,53,20,28,184,183,122,121,111,306,304,22448,3434544.0,22143,23256.0
7240,42,35,17,29,214,213,155,154,200,369,367,33170,6119865.0,32802,33855.75
7241,52,43,15,27,123,122,143,142,104,266,264,17589,2339337.0,17324,17556.0
7242,49,38,17,35,126,125,191,190,228,317,315,24066,3814461.0,23750,24963.75
7243,106,86,39,77,366,365,432,431,2232,798,796,158112,63086688.0,157315,158802.0
7244,115,95,40,77,478,477,329,328,1279,807,805,157262,63455217.0,156456,162408.75
7245,102,88,30,55,367,366,198,197,717,565,563,72666,20528145.0,72102,79523.75
7246,29,23,9,15,90,89,102,101,37,192,190,9180,881280.0,8989,9120.0
7247,46,45,12,12,140,139,174,173,130,314,312,24360,3824520.0,24047,24492.0
7249,47,41,12,21,104,103,119,118,76,223,221,12376,1379924.0,12154,12320.75
725,63,54,22,37,360,359,284,283,737,644,642,102240,32921280.0,101597,103362.0
7250,60,55,19,27,167,166,159,158,186,326,324,26553,4328139.0,26228,26406.0
7251,75,52,22,66,155,154,231,230,421,386,384,35805,6910365.0,35420,37056.0
7252,22,21,5,5,131,130,327,326,274,458,456,42837,9809673.0,42380,52212.0
7253,29,25,7,11,97,96,116,115,55,213,211,11252,1198338.0,11040,11235.75
7254,48,37,15,35,125,124,156,155,130,281,279,19500,2739750.0,19220,19599.75
7255,170,137,56,118,517,516,317,316,2648,834,832,163889,68341713.0,163056,173472.0
7256,52,47,18,26,161,160,107,106,88,268,266,17227,2308418.0,16960,17822.0
7257,71,63,21,34,253,252,162,161,412,415,413,40986,8504595.0,40572,42848.75
7258,34,28,11,19,135,134,90,89,57,225,223,12150,1366875.0,11926,12543.75
7259,36,32,13,19,125,124,131,130,67,256,254,16375,2096000.0,16120,16256.0
726,88,73,24,50,297,296,211,210,646,508,506,62667,15917418.0,62160,64262.0
7260,65,59,16,25,120,119,143,142,88,263,261,17160,2256540.0,16898,17160.75
7261,50,42,12,26,93,92,129,128,74,222,220,11997,1331667.0,11776,12210.0
7263,57,48,11,27,82,81,195,194,81,277,275,15990,2214615.0,15714,19043.75
7264,61,51,12,28,98,97,209,208,145,307,305,20482,3143987.0,20176,23408.75
7265,52,34,14,43,167,166,158,157,170,325,323,26386,4287725.0,26062,26243.75
7266,68,41,15,65,301,300,252,251,895,553,551,75852,20973078.0,75300,76175.75
7267,75,59,21,49,209,208,138,137,154,347,345,28842,5004087.0,28496,29928.75
7268,80,68,21,41,305,304,196,195,426,501,499,59780,14974890.0,59280,62499.75
7269,49,38,11,25,97,96,101,100,54,198,196,9797,969903.0,9600,9702.0
7270,39,34,11,16,101,100,136,135,82,237,235,13736,1627716.0,13500,13923.75
7271,83,64,27,60,181,180,221,220,212,402,400,40001,8040201.0,39600,40200.0
7272,54,44,15,33,121,120,296,295,299,417,415,35816,7467636.0,35400,43263.75
7273,56,47,18,33,125,124,206,205,147,331,329,25750,4261625.0,25420,27224.75
7274,58,51,18,30,135,134,98,97,63,233,231,13230,1541295.0,12998,13455.75
7275,44,41,10,14,112,111,163,162,77,275,273,18256,2510200.0,17982,18768.75
7276,67,58,27,43,167,166,134,133,124,301,299,22378,3367889.0,22078,22499.75
7277,125,97,38,88,216,215,280,279,500,496,494,60480,14999040.0,59985,61256.0
7278,76,66,27,45,143,142,163,162,124,306,304,23309,3566277.0,23004,23256.0
7279,95,94,3,3,101,100,147,146,72,248,246,14847,1841028.0,14600,15252.0
728,96,69,37,88,282,281,267,266,723,549,547,75294,20668203.0,74746,75075.75
7280,43,36,13,25,108,107,163,162,90,271,269,17604,2385342.0,17334,18224.75
7281,92,71,29,67,223,222,298,297,617,521,519,66454,17311267.0,65934,67599.75
7282,63,51,19,38,164,163,202,201,208,366,364,33128,6062424.0,32763,33306.0
7283,110,90,34,71,533,532,428,427,3803,961,959,228124,109613582.0,227164,230399.75
7284,47,41,13,23,89,88,102,101,59,191,189,9078,866949.0,8888,9024.75
7285,46,32,14,38,131,130,98,97,58,229,227,12838,1469951.0,12610,12995.75
7286,58,51,16,28,132,131,130,129,87,262,260,17160,2247960.0,16899,17030.0
7287,51,44,12,24,214,213,126,125,187,340,338,26964,4583880.0,26625,28730.0
7288,59,50,20,34,109,108,147,146,89,256,254,16023,2050944.0,15768,16256.0
7289,54,50,16,22,100,99,196,195,105,296,294,19600,2900800.0,19305,21756.0
729,69,57,19,35,164,163,124,123,144,288,286,20336,2928384.0,20049,20592.0
7290,51,45,14,23,241,240,214,213,358,455,453,51574,11733085.0,51120,51528.75
7292,38,27,11,22,131,130,163,162,164,294,292,21353,3138891.0,21060,21462.0
7293,66,59,18,30,234,233,157,156,279,391,389,36738,7182279.0,36348,38024.75
7294,65,55,11,26,215,214,95,94,121,310,308,20425,3165875.0,20116,23870.0
7295,78,72,24,34,124,123,233,232,156,357,355,28892,5157222.0,28536,31683.75
7296,44,35,13,28,124,123,107,106,54,231,229,13268,1532454.0,13038,13224.75
7297,53,43,11,27,130,129,98,97,62,228,226,12740,1452360.0,12513,12882.0
7298,64,58,23,33,223,222,166,165,286,389,387,37018,7200001.0,36630,37635.75
73,73,67,21,31,124,123,187,186,117,311,309,23188,3605734.0,22878,24024.75
730,61,54,13,25,86,85,108,107,50,194,192,9288,900936.0,9095,9312.0
7300,89,73,28,58,175,174,170,169,154,345,343,29750,5131875.0,29406,29583.75
7301,95,73,31,71,211,210,249,248,528,460,458,52539,12083970.0,52080,52670.0
7302,69,60,16,31,116,115,143,142,87,259,257,16588,2148146.0,16330,16640.75
7303,98,79,27,62,178,177,209,208,275,387,385,37202,7198587.0,36816,37248.75
7304,37,24,7,30,92,91,94,93,63,186,184,8648,804264.0,8463,8556.0
7305,57,50,17,29,157,156,101,100,74,258,256,15857,2045553.0,15600,16512.0
7306,55,43,17,39,418,417,423,422,2444,841,839,176814,74350287.0,175974,176399.75
7307,54,45,13,24,140,139,112,111,136,252,250,15680,1975680.0,15429,15750.0
7308,36,33,9,12,121,120,69,68,31,190,188,8349,793155.0,8160,8930.0
7309,72,61,18,37,195,194,140,139,141,335,333,27300,4572750.0,26966,27888.75
731,143,123,37,73,520,519,254,253,1864,774,772,132080,51114960.0,131307,149382.0
7310,53,43,17,33,229,228,154,153,261,383,381,35266,6753439.0,34884,36480.75
7311,87,67,39,77,419,418,269,268,726,688,686,112711,38772584.0,112024,117992.0
7312,69,55,22,48,213,212,129,128,251,342,340,27477,4698567.0,27136,29070.0
7313,27,22,9,15,91,90,129,128,44,220,218,11739,1291290.0,11520,11990.0
7314,62,52,14,32,166,165,134,133,117,300,298,22244,3336600.0,21945,22350.0
7315,40,37,11,15,112,111,244,243,198,356,354,27328,4864384.0,26973,31506.0
7316,49,41,14,26,139,138,89,88,80,228,226,12371,1410294.0,12144,12882.0
7317,55,44,16,33,127,126,117,116,71,244,242,14859,1812798.0,14616,14762.0
7318,71,52,20,56,288,287,213,212,542,501,499,61344,15366672.0,60844,62499.75
7319,64,54,15,33,166,165,128,127,137,294,292,21248,3123456.0,20955,21462.0
7320,58,49,17,31,103,102,181,180,103,284,282,18643,2647306.0,18360,20022.0
7321,121,106,28,56,229,228,287,286,672,516,514,65723,16956534.0,65208,66306.0
7322,63,48,16,43,214,213,203,202,412,417,415,43442,9057657.0,43026,43263.75
7324,31,25,10,20,94,93,114,113,39,208,206,10716,1114464.0,10509,10712.0
7325,50,28,10,46,151,150,185,184,168,336,334,27935,4693080.0,27600,28056.0
7327,66,59,23,33,177,176,208,207,303,385,383,36816,7087080.0,36432,36863.75
7328,41,37,13,19,186,185,156,155,187,342,340,29016,4961736.0,28675,29070.0
7329,20,16,6,10,123,122,96,95,57,219,217,11808,1292976.0,11590,11880.75
733,60,46,19,43,264,263,325,324,930,589,587,85800,25268100.0,85212,86435.75
7330,170,169,8,8,178,177,178,177,173,356,354,31684,5639752.0,31329,31506.0
7331,114,93,37,75,291,290,253,252,764,544,542,73623,20025456.0,73080,73712.0
7332,33,31,12,14,128,127,176,175,124,304,302,22528,3424256.0,22225,22952.0
7333,39,32,12,24,118,117,101,100,73,219,217,11918,1305021.0,11700,11880.75
7334,47,44,8,12,103,102,84,83,37,187,185,8652,808962.0,8466,8648.75
7335,47,37,16,34,205,204,110,109,146,315,313,22550,3551625.0,22236,24648.75
7336,76,63,24,48,408,407,430,429,3149,838,836,175440,73509360.0,174603,175142.0
7337,47,41,11,21,106,105,99,98,47,205,203,10494,1075635.0,10290,10403.75
7338,205,200,22,30,262,261,400,399,2332,662,660,104800,34688800.0,104139,109230.0
7339,52,49,14,18,107,106,76,75,42,183,181,8132,744078.0,7950,8280.75
734,84,77,15,27,126,125,105,104,64,231,229,13230,1528065.0,13000,13224.75
7340,53,41,17,37,105,104,137,136,96,242,240,14385,1740585.0,14144,14520.0
7341,42,37,17,23,172,171,137,136,189,309,307,23564,3640638.0,23256,23715.75
7342,75,70,22,29,162,161,261,260,310,423,421,42282,8942643.0,41860,44520.75
7343,55,47,13,24,120,119,98,97,76,218,216,11760,1281840.0,11543,11772.0
7344,35,28,9,15,141,140,203,202,159,344,342,28623,4923156.0,28280,29412.0
7345,58,51,20,32,190,189,324,323,380,514,512,61560,15820920.0,61047,65792.0
7346,38,34,14,20,207,206,134,133,151,341,339,27738,4729329.0,27398,28899.75
7347,26,20,9,18,129,128,112,111,75,241,239,14448,1740984.0,14208,14399.75
7348,81,72,22,38,167,166,396,395,541,563,561,66132,18616158.0,65570,78960.75
7349,98,84,27,53,155,154,261,260,351,416,414,40455,8414640.0,40040,43056.0
735,55,47,19,33,130,129,111,110,67,241,239,14430,1738815.0,14190,14399.75
7350,33,27,12,22,338,337,179,178,428,517,515,60502,15639767.0,59986,66563.75
7351,71,69,14,15,121,120,144,143,99,265,263,17424,2308680.0,17160,17423.75
7352,54,49,12,20,122,121,106,105,61,228,226,12932,1474248.0,12705,12882.0
7353,161,131,48,106,378,377,335,334,2344,713,711,126630,45143595.0,125918,126735.75
7354,44,29,15,40,148,147,142,141,138,290,288,21016,3047320.0,20727,20880.0
7355,52,43,20,34,123,122,173,172,104,296,294,21279,3149292.0,20984,21756.0
7356,60,51,13,29,114,113,163,162,94,277,275,18582,2573607.0,18306,19043.75
7357,59,46,12,29,171,170,127,126,124,298,296,21717,3235833.0,21420,22052.0
7358,73,65,22,36,240,239,264,263,450,504,502,63360,15966720.0,62857,63252.0
7359,26,20,9,18,189,188,147,146,204,336,334,27783,4667544.0,27448,28056.0
736,41,37,14,20,245,244,216,215,381,461,459,52920,12198060.0,52460,52899.75
7360,108,90,36,70,302,301,252,251,860,554,552,76104,21080808.0,75551,76452.0
7361,77,64,20,42,157,156,165,164,158,322,320,25905,4170705.0,25584,25760.0
7362,42,30,12,34,116,115,129,128,87,245,243,14964,1833090.0,14720,14883.75
7363,57,48,18,33,134,133,142,141,99,276,274,19028,2625864.0,18753,18906.0
7364,95,85,22,40,171,170,350,349,487,521,519,59850,15590925.0,59330,67599.75
7365,69,52,20,51,162,161,181,180,170,343,341,29322,5028723.0,28980,29240.75
7366,51,44,13,25,71,70,130,129,54,201,199,9230,927615.0,9030,9999.75
7367,107,84,31,73,199,198,319,318,552,518,516,63481,16441579.0,62964,66822.0
7368,77,63,20,42,268,267,181,180,395,449,447,48508,10890046.0,48060,50175.75
7369,36,29,8,17,72,71,145,144,46,217,215,10440,1132740.0,10224,11663.75
737,44,31,12,35,146,145,155,154,227,301,299,22630,3405815.0,22330,22499.75
7370,101,85,32,61,295,294,267,266,559,562,560,78765,22132965.0,78204,78680.0
7371,60,51,20,31,249,248,238,237,784,487,485,59262,14430297.0,58776,59048.75
7372,66,56,29,47,240,239,223,222,404,463,461,53520,12389880.0,53058,53360.75
7373,43,31,15,36,137,136,116,115,84,253,251,15892,2010338.0,15640,15875.75
7374,74,61,25,49,181,180,384,383,813,565,563,69504,19634880.0,68940,79523.75
7375,49,40,12,23,126,125,134,133,122,260,258,16884,2194920.0,16625,16770.0
7376,53,42,18,37,206,205,211,210,336,417,415,43466,9062661.0,43050,43263.75
7377,54,47,12,24,294,293,194,193,577,488,486,57036,13916784.0,56549,59292.0
7378,21,18,9,12,156,155,95,94,82,251,249,14820,1859910.0,14570,15624.75
7379,50,41,18,33,151,150,180,179,144,331,329,27180,4498290.0,26850,27224.75
738,52,46,12,22,95,94,91,90,44,186,184,8645,803985.0,8460,8556.0
7380,57,49,16,28,119,118,112,111,65,231,229,13328,1539384.0,13098,13224.75
7381,41,37,17,21,138,137,244,243,196,382,380,33672,6431352.0,33291,36290.0
7382,29,20,8,18,105,104,109,108,55,214,212,11445,1224615.0,11232,11342.0
7383,68,59,17,33,123,122,179,178,143,302,300,22017,3324567.0,21716,22650.0
7384,87,67,28,66,197,196,349,348,663,546,544,68753,18769569.0,68208,74256.0
7385,61,43,20,51,358,357,497,496,3035,855,853,177926,76063365.0,177072,182328.75
7386,73,68,17,25,156,155,149,148,126,305,303,23244,3544710.0,22940,23103.75
7388,62,55,15,27,133,132,148,147,86,281,279,19684,2765602.0,19404,19599.75
7389,58,52,17,26,118,117,180,179,147,298,296,21240,3164760.0,20943,22052.0
739,60,47,15,34,158,157,121,120,142,279,277,19118,2666961.0,18840,19320.75
7390,34,22,7,26,166,165,127,126,120,293,291,21082,3088513.0,20790,21315.75
7391,38,31,12,19,133,132,194,193,176,327,325,25802,4218627.0,25476,26568.75
7392,63,56,18,29,123,122,227,226,158,350,348,27921,4886175.0,27572,30450.0
7393,41,32,15,25,136,135,156,155,175,292,290,21216,3097536.0,20925,21170.0
7394,39,36,9,13,154,153,97,96,71,251,249,14938,1874719.0,14688,15624.75
7395,40,30,10,26,148,147,155,154,140,303,301,22940,3475410.0,22638,22800.75
7396,74,66,24,36,108,107,148,147,147,256,254,15984,2045952.0,15729,16256.0
7397,25,23,11,12,86,85,238,237,142,324,322,20468,3315816.0,20145,26082.0
7398,41,36,11,17,337,336,162,161,407,499,497,54594,13621203.0,54096,62000.75
7399,52,44,21,33,260,259,251,250,606,511,509,65260,16673930.0,64750,65024.75
74,41,34,19,30,116,115,162,161,129,278,276,18792,2612088.0,18515,19182.0
740,67,58,23,33,194,193,117,116,209,311,309,22698,3529539.0,22388,24024.75
7400,50,38,18,39,356,355,268,267,783,624,622,95408,29767296.0,94785,97032.0
7401,71,62,16,30,151,150,300,299,380,451,449,45300,10215150.0,44850,50624.75
7402,128,106,47,84,356,355,310,309,980,666,664,110360,36749880.0,109695,110556.0
7403,92,73,39,75,367,366,332,331,1425,699,697,121844,42584478.0,121146,121800.75
7404,79,59,22,60,188,187,206,205,281,394,392,38728,7629416.0,38335,38612.0
7405,109,96,31,50,277,276,193,192,434,470,468,53461,12563335.0,52992,54990.0
7406,78,58,23,59,216,215,170,169,293,386,384,36720,7086960.0,36335,37056.0
7407,40,38,11,13,82,81,86,85,33,168,166,7052,592368.0,6885,6972.0
7408,92,80,29,48,175,174,223,222,374,398,396,39025,7765975.0,38628,39402.0
7409,107,87,32,70,257,256,216,215,702,473,471,55512,13128588.0,55040,55695.75
741,25,23,6,8,447,446,270,269,1823,717,715,120690,43267365.0,119974,128163.75
7410,42,35,11,22,118,117,102,101,64,220,218,12036,1323960.0,11817,11990.0
7411,64,55,15,31,154,153,205,204,335,359,357,31570,5666815.0,31212,32040.75
7412,140,139,7,7,147,146,147,146,117,294,292,21609,3176523.0,21316,21462.0
7413,42,31,8,28,245,244,171,170,358,416,414,41895,8714160.0,41480,43056.0
7414,40,37,12,16,197,196,111,110,119,308,306,21867,3367518.0,21560,23562.0
7415,82,70,20,34,229,228,187,186,313,416,414,42823,8907184.0,42408,43056.0
7416,24,19,7,11,143,142,103,102,65,246,244,14729,1811667.0,14484,15006.0
7417,70,59,19,36,151,150,197,196,177,348,346,29747,5175978.0,29400,30102.0
7418,67,59,24,35,146,145,200,199,160,346,344,29200,5051600.0,28855,29756.0
7419,63,49,21,42,129,128,184,183,136,313,311,23736,3714684.0,23424,24335.75
742,53,46,22,33,184,183,177,176,179,361,359,32568,5878524.0,32208,32399.75
7420,56,51,15,22,227,226,129,128,178,356,354,29283,5212374.0,28928,31506.0
7421,18,17,5,5,129,128,121,120,88,250,248,15609,1951125.0,15360,15500.0
7422,78,67,22,41,193,192,147,146,159,340,338,28371,4823070.0,28032,28730.0
7423,54,49,18,26,197,196,112,111,116,309,307,22064,3408888.0,21756,23715.75
7424,76,68,19,33,267,266,208,207,326,475,473,55536,13189800.0,55062,56168.75
7426,50,36,15,41,209,208,182,181,238,391,389,38038,7436429.0,37648,38024.75
7427,20,17,7,10,162,161,202,201,222,364,362,32724,5955768.0,32361,32942.0
7428,78,73,16,24,105,104,108,107,51,213,211,11340,1207710.0,11128,11235.75
7429,76,64,23,45,128,127,191,190,123,319,317,24448,3899456.0,24130,25280.75
743,43,35,12,25,114,113,187,186,119,301,299,21318,3208359.0,21018,22499.75
7430,83,66,26,58,254,253,347,346,908,601,599,88138,26485469.0,87538,89999.75
7431,66,53,23,47,224,223,150,149,235,374,372,33600,6283200.0,33227,34782.0
7432,124,118,13,23,178,177,147,146,201,325,323,26166,4251975.0,25842,26243.75
7433,82,68,27,51,217,216,372,371,719,589,587,80724,23773218.0,80136,86435.75
7434,62,51,20,39,161,160,194,193,204,355,353,31234,5544035.0,30880,31328.75
7435,70,60,20,36,134,133,110,109,75,244,242,14740,1798280.0,14497,14762.0
7436,46,38,11,22,154,153,108,107,68,262,260,16632,2178792.0,16371,17030.0
7437,390,382,13,27,405,404,405,404,3156,810,808,164025,66430125.0,163216,163620.0
7438,70,59,27,47,186,185,148,147,199,334,332,27528,4597176.0,27195,27722.0
7439,35,27,12,26,375,374,196,195,842,571,569,73500,20984250.0,72930,81224.75
744,121,101,37,75,272,271,245,244,518,517,515,66640,17226440.0,66124,66563.75
7440,67,54,24,46,237,236,310,309,696,547,545,73470,20094045.0,72924,74528.75
7441,113,92,31,70,216,215,248,247,573,464,462,53568,12427776.0,53105,53592.0
7442,43,34,9,23,150,149,150,149,133,300,298,22500,3375000.0,22201,22350.0
7443,73,64,23,37,244,243,128,127,179,372,370,31232,5809152.0,30861,34410.0
7444,104,88,31,61,280,279,196,195,414,476,474,54880,13061440.0,54405,56406.0
7446,30,25,9,15,78,77,132,131,52,210,208,10296,1081080.0,10087,10920.0
7447,55,53,12,14,101,100,83,82,33,184,182,8383,771236.0,8200,8372.0
7448,60,53,18,29,194,193,130,129,141,324,322,25220,4085640.0,24897,26082.0
7449,61,52,23,38,476,475,374,373,2437,850,848,178024,75660200.0,177175,180200.0
745,64,62,16,18,107,106,186,185,126,293,291,19902,2915643.0,19610,21315.75
7450,141,120,50,89,397,396,438,437,1950,835,833,173886,72597405.0,173052,173888.75
7451,36,28,9,23,138,137,110,109,105,248,246,15180,1882320.0,14933,15252.0
7452,43,26,9,39,422,421,233,232,994,655,653,98326,32201765.0,97672,106928.75
7453,29,20,5,13,81,80,115,114,51,196,194,9315,912870.0,9120,9506.0
7454,93,81,20,41,143,142,177,176,119,320,318,25311,4049760.0,24992,25440.0
7455,91,79,32,54,177,176,219,218,283,396,394,38763,7675074.0,38368,39006.0
7456,29,27,9,11,271,270,179,178,353,450,448,48509,10914525.0,48060,50400.0
7457,45,40,18,25,199,198,145,144,352,344,342,28855,4963060.0,28512,29412.0
7458,33,25,8,18,99,98,94,93,54,193,191,9306,898029.0,9114,9215.75
7459,48,43,12,20,175,174,118,117,110,293,291,20650,3025225.0,20358,21315.75
746,86,77,22,37,144,143,303,302,355,447,445,43632,9751752.0,43186,49728.75
7460,91,66,29,77,374,373,253,252,949,627,625,94622,29663997.0,93996,97968.75
7461,211,171,50,128,407,406,478,477,2643,885,883,194546,86086605.0,193662,195363.75
7462,25,18,13,25,146,145,226,225,214,372,370,32996,6137256.0,32625,34410.0
7463,85,68,26,54,158,157,211,210,230,369,367,33338,6150861.0,32970,33855.75
7464,39,27,9,30,175,174,223,222,320,398,396,39025,7765975.0,38628,39402.0
7465,152,130,40,82,308,307,250,249,749,558,556,77000,21483000.0,76443,77562.0
7466,74,59,22,48,224,223,231,230,381,455,453,51744,11771760.0,51290,51528.75
7467,78,66,24,46,166,165,143,142,184,309,307,23738,3667521.0,23430,23715.75
7468,123,97,51,101,385,384,320,319,1246,705,703,123200,43428000.0,122496,123903.75
7469,86,77,30,40,201,200,184,183,358,385,383,36984,7119420.0,36600,36863.75
747,57,38,12,46,259,258,183,182,387,442,440,47397,10474737.0,46956,48620.0
7470,46,37,15,31,102,101,188,187,122,290,288,19176,2780520.0,18887,20880.0
7471,40,31,11,27,136,135,221,220,240,357,355,30056,5364996.0,29700,31683.75
7472,71,60,24,43,366,365,223,222,725,589,587,81618,24036501.0,81030,86435.75
7473,40,32,16,29,119,118,112,111,65,231,229,13328,1539384.0,13098,13224.75
7474,34,25,9,24,107,106,143,142,131,250,248,15301,1912625.0,15052,15500.0
7475,48,43,14,22,178,177,95,94,93,273,271,16910,2308215.0,16638,18495.75
7476,93,81,32,54,338,337,436,435,3231,774,772,147368,57031416.0,146595,149382.0
7477,64,49,15,38,221,220,263,262,588,484,482,58123,14065766.0,57640,58322.0
7478,77,63,23,48,458,457,236,235,990,694,692,108088,37506536.0,107395,120062.0
7479,63,51,18,40,165,164,190,189,246,355,353,31350,5564625.0,30996,31328.75
7480,87,66,21,61,137,136,179,178,157,316,314,24523,3874634.0,24208,24806.0
7481,49,43,15,25,184,183,148,147,163,332,330,27232,4520512.0,26901,27390.0
7482,60,50,18,36,117,116,132,131,81,249,247,15444,1922778.0,15196,15375.75
7484,38,30,12,22,88,87,103,102,69,191,189,9064,865612.0,8874,9024.75
7485,50,41,19,31,135,134,198,197,171,333,331,26730,4450545.0,26398,27555.75
7486,44,31,14,35,120,119,212,211,178,332,330,25440,4223040.0,25109,27390.0
7487,257,256,10,10,267,266,267,266,598,534,532,71289,19034163.0,70756,71022.0
7488,83,71,19,41,174,173,205,204,184,379,377,35670,6759465.0,35292,35720.75
7489,109,93,39,69,293,292,303,302,719,596,594,88779,26456142.0,88184,88506.0
749,86,73,22,46,155,154,146,145,179,301,299,22630,3405815.0,22330,22499.75
7490,41,35,13,20,136,135,105,104,63,241,239,14280,1720740.0,14040,14399.75
7491,131,120,14,34,170,169,178,177,262,348,346,30260,5265240.0,29913,30102.0
7492,94,72,30,72,387,386,346,345,1269,733,731,133902,49075083.0,133170,133955.75
7493,55,46,14,29,147,146,142,141,118,289,287,20874,3016293.0,20586,20735.75
7494,124,104,32,70,274,273,277,276,734,551,549,75898,20909899.0,75348,75624.75
7495,66,52,28,54,199,198,149,148,189,348,346,29651,5159274.0,29304,30102.0
7496,54,50,15,19,106,105,156,155,83,262,260,16536,2166216.0,16275,17030.0
7497,29,27,11,12,216,215,88,87,105,304,302,19008,2889216.0,18705,22952.0
7498,99,90,18,34,274,273,189,188,484,463,461,51786,11988459.0,51324,53360.75
7499,50,42,12,20,184,183,153,152,239,337,335,28152,4743612.0,27816,28223.75
7500,41,36,13,20,165,164,242,241,225,407,405,39930,8125755.0,39524,41208.75
7501,63,56,12,20,103,102,116,115,43,219,217,11948,1308306.0,11730,11880.75
7502,29,22,6,12,89,88,142,141,60,231,229,12638,1459689.0,12408,13224.75
7504,83,71,28,49,206,205,313,312,486,519,517,64478,16732041.0,63960,67080.75
7505,140,138,9,11,170,169,147,146,154,317,315,24990,3960915.0,24674,24963.75
7506,93,82,28,46,302,301,214,213,456,516,514,64628,16674024.0,64113,66306.0
7507,131,106,42,90,269,268,318,317,674,587,585,85542,25106577.0,84956,85848.75
7508,368,366,12,14,447,446,380,379,3307,827,825,169860,70237110.0,169034,170568.75
7509,30,28,7,9,408,407,141,140,394,549,547,57528,15791436.0,56980,75075.75
751,56,46,13,31,91,90,109,108,48,200,198,9919,991900.0,9720,9900.0
7510,79,60,31,67,247,246,274,273,431,521,519,67678,17630119.0,67158,67599.75
7511,57,47,22,39,323,322,168,167,401,491,489,54264,13321812.0,53774,60024.75
7512,29,23,13,23,384,383,120,119,391,504,502,46080,11612160.0,45577,63252.0
7513,66,56,19,37,145,144,234,233,200,379,377,33930,6429735.0,33552,35720.75
7514,89,81,25,39,201,200,168,167,211,369,367,33768,6230196.0,33400,33855.75
7515,65,58,20,31,190,189,162,161,163,352,350,30780,5417280.0,30429,30800.0
7516,56,51,15,23,148,147,176,175,149,324,322,26048,4219776.0,25725,26082.0
7517,54,49,12,18,126,125,112,111,67,238,236,14112,1679328.0,13875,14042.0
7519,49,37,12,34,223,222,138,137,197,361,359,30774,5554707.0,30414,32399.75
752,76,55,26,64,257,256,163,162,315,420,418,41891,8797110.0,41472,43890.0
7520,39,35,12,16,158,157,146,145,110,304,302,23068,3506336.0,22765,22952.0
7522,148,125,42,86,307,306,307,306,1127,614,612,94249,28934443.0,93636,93942.0
7523,92,75,25,55,212,211,175,174,295,387,385,37100,7178850.0,36714,37248.75
7524,34,28,8,17,144,143,133,132,130,277,275,19152,2652552.0,18876,19043.75
7525,46,34,13,30,86,85,119,118,50,205,203,10234,1048985.0,10030,10403.75
7526,43,35,16,30,112,111,133,132,82,245,243,14896,1824760.0,14652,14883.75
7527,67,52,14,41,170,169,133,132,142,303,301,22610,3425415.0,22308,22800.75
7528,37,30,14,24,97,96,260,259,239,357,355,25220,4501770.0,24864,31683.75
7529,48,38,13,31,141,140,231,230,266,372,370,32571,6058206.0,32200,34410.0
753,50,46,13,19,72,71,103,102,42,175,173,7416,648900.0,7242,7568.75
7530,91,69,34,75,268,267,269,268,653,537,535,72092,19356702.0,71556,71823.75
7532,85,70,23,49,290,289,266,265,869,556,554,77140,21444920.0,76585,77006.0
7533,52,48,12,18,179,178,140,139,202,319,317,25060,3997070.0,24742,25280.75
7534,78,72,15,25,189,188,170,169,234,359,357,32130,5767335.0,31772,32040.75
7535,55,48,17,28,149,148,107,106,123,256,254,15943,2040704.0,15688,16256.0
7536,112,94,34,66,318,317,386,385,1826,704,702,122748,43207296.0,122045,123552.0
7537,86,81,21,29,169,168,215,214,185,384,382,36335,6976320.0,35952,36672.0
7538,72,55,27,56,321,320,209,208,503,530,528,67089,17778585.0,66560,69960.0
7539,60,47,22,45,373,372,408,407,2851,781,779,152184,59427852.0,151404,152099.75
754,56,47,21,37,171,170,129,128,129,300,298,22059,3308850.0,21760,22350.0
7540,85,60,21,68,202,201,234,233,522,436,434,47268,10304424.0,46833,47306.0
7541,60,54,11,20,216,215,123,122,131,339,337,26568,4503276.0,26230,28560.75
7542,24,22,7,9,122,121,116,115,66,238,236,14152,1684088.0,13915,14042.0
7543,35,30,13,20,136,135,239,238,162,375,373,32504,6094500.0,32130,34968.75
7544,64,54,18,35,167,166,110,109,125,277,275,18370,2544245.0,18094,19043.75
7545,71,63,21,34,125,124,202,201,204,327,325,25250,4128375.0,24924,26568.75
7546,32,27,8,15,224,223,90,89,98,314,312,20160,3165120.0,19847,24492.0
7547,45,41,12,18,104,103,88,87,40,192,190,9152,878592.0,8961,9120.0
7548,64,59,10,18,154,153,98,97,67,252,250,15092,1901592.0,14841,15750.0
7549,55,49,14,24,235,234,174,173,560,409,407,40890,8362005.0,40482,41615.75
755,67,57,27,45,183,182,160,159,161,343,341,29280,5021520.0,28938,29240.75
7550,73,64,21,37,217,216,124,123,167,341,339,26908,4587814.0,26568,28899.75
7552,86,74,20,40,176,175,159,158,174,335,333,27984,4687320.0,27650,27888.75
7553,52,47,15,21,121,120,181,180,116,302,300,21901,3307051.0,21600,22650.0
7554,51,46,15,21,165,164,111,110,117,276,274,18315,2527470.0,18040,18906.0
7555,92,78,25,50,267,266,172,171,333,439,437,45924,10080318.0,45486,47960.75
7556,36,35,12,12,232,231,82,81,126,314,312,19024,2986768.0,18711,24492.0
7557,55,49,15,25,171,170,121,120,120,292,290,20691,3020886.0,20400,21170.0
7558,50,46,19,25,289,288,169,168,296,458,456,48841,11184589.0,48384,52212.0
7559,52,48,11,17,181,180,117,116,112,298,296,21177,3155373.0,20880,22052.0
7560,64,56,25,39,127,126,156,155,104,283,281,19812,2803398.0,19530,19880.75
7561,54,52,14,16,138,137,145,144,83,283,281,20010,2831415.0,19728,19880.75
7562,103,88,33,61,320,319,436,435,2249,756,754,139520,52738560.0,138765,142506.0
7563,45,31,11,36,123,122,127,126,99,250,248,15621,1952625.0,15372,15500.0
7564,36,32,15,20,98,97,213,212,117,311,309,20874,3245907.0,20564,24024.75
7565,82,63,21,55,379,378,373,372,3307,752,750,141367,53153992.0,140616,141000.0
7566,46,39,14,26,214,213,126,125,231,340,338,26964,4583880.0,26625,28730.0
7567,29,22,9,17,95,94,169,168,114,264,262,16055,2119260.0,15792,17292.0
7568,88,71,26,57,213,212,287,286,536,500,498,61131,15282750.0,60632,62250.0
7569,56,53,21,25,210,209,98,97,102,308,306,20580,3169320.0,20273,23562.0
7570,67,56,24,42,264,263,225,224,536,489,487,59400,14523300.0,58912,59535.75
7571,49,40,14,25,137,136,92,91,58,229,227,12604,1443158.0,12376,12995.75
7572,27,25,6,7,146,145,127,126,106,273,271,18542,2530983.0,18270,18495.75
7573,81,67,19,45,192,191,190,189,315,382,380,36480,6967680.0,36099,36290.0
7574,100,75,44,90,499,498,527,526,2887,1026,1024,262973,134905149.0,261948,262656.0
7576,133,112,38,77,383,382,367,366,1856,750,748,140561,52710375.0,139812,140250.0
7577,37,27,8,23,146,145,152,151,153,298,296,22192,3306608.0,21895,22052.0
7578,43,39,8,14,170,169,77,76,66,247,245,13090,1616615.0,12844,15128.75
7579,79,60,28,64,421,420,384,383,2420,805,803,161664,65069760.0,160860,161603.75
758,156,123,51,115,434,433,443,442,3024,877,875,192262,84306887.0,191386,191843.75
7580,84,63,26,66,213,212,282,281,609,495,493,60066,14866335.0,59572,61008.75
7581,134,115,35,71,306,305,227,226,661,533,531,69462,18511623.0,68930,70755.75
7582,41,36,14,22,221,220,100,99,171,321,319,22100,3547050.0,21780,25599.75
7583,81,70,20,40,259,258,245,244,653,504,502,63455,15990660.0,62952,63252.0
7584,76,64,21,43,250,249,157,156,300,407,405,39250,7987375.0,38844,41208.75
7585,57,49,18,31,126,125,153,152,86,279,277,19278,2689281.0,19000,19320.75
7586,40,31,13,24,110,109,113,112,89,223,221,12430,1385945.0,12208,12320.75
7587,96,78,28,62,341,340,305,304,1397,646,644,104005,33593615.0,103360,104006.0
7588,77,70,30,41,219,218,491,490,1582,710,708,107529,38172795.0,106820,125670.0
7589,40,33,9,21,118,117,232,231,280,350,348,27376,4790800.0,27027,30450.0
759,84,71,33,57,328,327,398,397,1670,726,724,130544,47387472.0,129819,131406.0
7590,62,58,18,24,110,109,153,152,167,263,261,16830,2213145.0,16568,17160.75
7591,137,111,40,89,462,461,309,308,2828,771,769,142758,55033209.0,141988,148224.75
7592,60,51,16,32,113,112,178,177,102,291,289,20114,2926587.0,19824,21024.75
7593,88,78,13,26,137,136,142,141,143,279,277,19454,2713833.0,19176,19320.75
7594,28,27,9,9,107,106,155,154,96,262,260,16585,2172635.0,16324,17030.0
7595,52,47,17,25,202,201,128,127,134,330,328,25856,4266240.0,25527,27060.0
7596,419,411,13,27,439,438,501,500,7448,940,938,219939,103371330.0,219000,220430.0
7597,77,65,21,43,186,185,188,187,184,374,372,34968,6539016.0,34595,34782.0
7598,97,92,16,24,173,172,144,143,134,317,315,24912,3948552.0,24596,24963.75
7599,54,50,16,22,156,155,153,152,137,309,307,23868,3687606.0,23560,23715.75
76,86,75,31,51,213,212,187,186,222,400,398,39831,7966200.0,39432,39800.0
760,40,31,13,27,116,115,92,91,68,208,206,10672,1109888.0,10465,10712.0
7600,53,41,17,37,222,221,210,209,337,432,430,46620,10069920.0,46189,46440.0
7601,56,40,20,48,172,171,170,169,238,342,340,29240,5000040.0,28899,29070.0
7602,29,27,8,9,223,222,175,174,215,398,396,39025,7765975.0,38628,39402.0
7603,99,91,23,36,158,157,165,164,142,323,321,26070,4210305.0,25748,25920.75
7604,112,106,12,22,331,330,178,177,545,509,507,58918,14994631.0,58410,64515.75
7605,114,113,6,6,124,123,170,169,119,294,292,21080,3098760.0,20787,21462.0
7606,141,139,9,11,239,238,147,146,202,386,384,35133,6780669.0,34748,37056.0
7607,55,49,17,27,210,209,124,123,180,334,332,26040,4348680.0,25707,27722.0
7608,52,46,15,25,185,184,103,102,102,288,286,19055,2743920.0,18768,20592.0
7609,82,76,22,31,137,136,147,146,96,284,282,20139,2859738.0,19856,20022.0
761,34,30,9,13,205,204,271,270,455,476,474,55555,13222090.0,55080,56406.0
7610,80,67,24,46,195,194,130,129,159,325,323,25350,4119375.0,25026,26243.75
7611,84,76,20,33,214,213,253,252,409,467,465,54142,12642157.0,53676,54288.75
7612,42,32,12,29,124,123,210,209,233,334,332,26040,4348680.0,25707,27722.0
7614,73,59,20,45,381,380,474,473,5366,855,853,180594,77203935.0,179740,182328.75
7615,54,48,16,26,161,160,170,169,224,331,329,27370,4529735.0,27040,27224.75
7616,16,15,3,3,217,216,140,139,199,357,355,30380,5422830.0,30024,31683.75
7617,90,75,25,52,441,440,387,386,4200,828,826,170667,70656138.0,169840,170982.0
7618,81,72,17,31,177,176,170,169,169,347,345,30090,5220615.0,29744,29928.75
7619,163,136,56,107,454,453,369,368,2044,823,821,167526,68936949.0,166704,168920.75
762,55,47,19,33,153,152,227,226,266,380,378,34731,6598890.0,34352,35910.0
7620,45,30,8,34,183,182,106,105,143,289,287,19398,2803011.0,19110,20735.75
7621,48,36,15,36,129,128,147,146,96,276,274,18963,2616894.0,18688,18906.0
7622,48,37,11,30,119,118,86,85,58,205,203,10234,1048985.0,10030,10403.75
7623,58,50,18,29,155,154,127,126,136,282,280,19685,2775585.0,19404,19740.0
7624,36,30,16,24,136,135,242,241,170,378,376,32912,6220368.0,32535,35532.0
7625,89,78,24,42,344,343,176,175,421,520,518,60544,15741440.0,60025,67340.0
7626,123,90,42,102,363,362,482,481,2148,845,843,174966,73923135.0,174122,178083.75
7627,51,47,12,18,113,112,130,129,74,243,241,14690,1784835.0,14448,14640.75
763,31,28,10,14,152,151,71,70,59,223,221,10792,1203308.0,10570,12320.75
7630,48,42,15,24,154,153,214,213,179,368,366,32956,6063904.0,32589,33672.0
7631,81,79,27,29,279,278,197,196,659,476,474,54963,13081194.0,54488,56406.0
7632,110,105,11,18,178,177,239,238,442,417,415,42542,8870007.0,42126,43263.75
7633,32,23,9,20,138,137,102,101,100,240,238,14076,1689120.0,13837,14280.0
7634,38,32,13,19,203,202,197,196,300,400,398,39991,7998200.0,39592,39800.0
7635,48,44,8,14,80,79,156,155,96,236,234,12480,1472640.0,12245,13806.0
7636,58,52,22,32,236,235,108,107,136,344,342,25488,4383936.0,25145,29412.0
7637,74,66,20,32,210,209,190,189,359,400,398,39900,7980000.0,39501,39800.0
7639,39,33,12,19,116,115,114,113,74,230,228,13224,1520760.0,12995,13110.0
764,85,62,17,58,166,165,203,202,278,369,367,33698,6217281.0,33330,33855.75
7640,42,31,9,29,96,95,95,94,55,191,189,9120,870960.0,8930,9024.75
7641,40,33,7,19,210,209,164,163,305,374,372,34440,6440280.0,34067,34782.0
7642,57,47,14,32,148,147,171,170,146,319,317,25308,4036626.0,24990,25280.75
7644,146,145,2,2,147,146,262,261,294,409,407,38514,7876113.0,38106,41615.75
7646,48,38,12,23,146,145,141,140,107,287,285,20586,2954091.0,20300,20448.75
7647,44,41,15,18,236,235,175,174,544,411,409,41300,8487150.0,40890,42024.75
7648,46,35,15,35,91,90,181,180,82,272,270,16471,2240056.0,16200,18360.0
7649,29,23,9,18,198,197,133,132,177,331,329,26334,4358277.0,26004,27224.75
765,126,104,41,81,355,354,297,296,1883,652,650,105435,34371810.0,104784,105950.0
7650,37,33,13,17,109,108,154,153,95,263,261,16786,2207359.0,16524,17160.75
7651,23,20,7,10,118,117,149,148,87,267,265,17582,2347197.0,17316,17688.75
7652,47,36,21,40,233,232,161,160,303,394,392,37513,7390061.0,37120,38612.0
7653,52,44,14,25,131,130,207,206,182,338,336,27117,4582773.0,26780,28392.0
7654,109,83,32,79,287,286,239,238,689,526,524,68593,18039959.0,68068,68906.0
7655,30,26,8,11,148,147,86,85,69,234,232,12728,1489176.0,12495,13572.0
7656,49,42,14,25,221,220,158,157,236,379,377,34918,6616961.0,34540,35720.75
7657,53,50,17,21,121,120,85,84,46,206,204,10285,1059355.0,10080,10506.0
7658,70,63,19,31,214,213,124,123,137,338,336,26536,4484584.0,26199,28392.0
766,56,45,18,29,159,158,176,175,177,335,333,27984,4687320.0,27650,27888.75
7660,66,59,16,24,152,151,124,123,121,276,274,18848,2601024.0,18573,18906.0
7661,29,23,9,17,177,176,125,124,112,302,300,22125,3340875.0,21824,22650.0
7662,120,103,34,66,337,336,220,219,558,557,555,74140,20647990.0,73584,77283.75
7663,68,56,21,43,139,138,143,142,118,282,280,19877,2802657.0,19596,19740.0
7664,52,44,15,27,100,99,117,116,54,217,215,11700,1269450.0,11484,11663.75
7665,53,47,12,22,139,138,106,105,77,245,243,14734,1804915.0,14490,14883.75
7666,175,172,13,17,285,284,193,192,507,478,476,55005,13146195.0,54528,56882.0
7667,37,35,13,15,122,121,267,266,256,389,387,32574,6335643.0,32186,37635.75
7668,36,31,11,16,148,147,183,182,155,331,329,27084,4482402.0,26754,27224.75
7669,31,27,11,16,169,168,144,143,147,313,311,24336,3808584.0,24024,24335.75
767,60,49,16,36,220,219,188,187,263,408,406,41360,8437440.0,40953,41412.0
7670,60,49,24,44,234,233,261,260,645,495,493,61074,15115815.0,60580,61008.75
7671,36,32,13,19,143,142,141,140,107,284,282,20163,2863146.0,19880,20022.0
7672,46,41,15,22,169,168,116,115,117,285,283,19604,2793570.0,19320,20163.75
7675,26,22,9,14,149,148,90,89,79,239,237,13410,1602495.0,13172,14160.75
7676,61,53,15,29,165,164,187,186,269,352,350,30855,5430480.0,30504,30800.0
7677,57,50,20,30,141,140,188,187,192,329,327,26508,4360566.0,26180,26895.75
7678,29,28,9,9,340,339,191,190,530,531,529,64940,17241570.0,64410,70224.75
7679,96,83,28,52,230,229,294,293,573,524,522,67620,17716440.0,67097,68382.0
768,55,47,16,30,156,155,86,85,60,242,240,13416,1623336.0,13175,14520.0
7680,52,31,18,57,127,126,145,144,116,272,270,18415,2504440.0,18144,18360.0
7681,48,45,9,13,111,110,73,72,28,184,182,8103,745476.0,7920,8372.0
7682,111,106,12,19,178,177,239,238,362,417,415,42542,8870007.0,42126,43263.75
7683,54,42,18,38,139,138,131,130,102,270,268,18209,2458215.0,17940,18090.0
7684,257,256,10,10,267,266,267,266,598,534,532,71289,19034163.0,70756,71022.0
7685,49,44,13,21,113,112,115,114,70,228,226,12995,1481430.0,12768,12882.0
7686,181,180,13,13,354,353,193,192,706,547,545,68322,18686067.0,67776,74528.75
7687,41,36,14,22,145,144,159,158,142,304,302,23055,3504360.0,22752,22952.0
7688,75,63,20,41,167,166,183,182,200,350,348,30561,5348175.0,30212,30450.0
7689,144,117,38,89,276,275,340,339,750,616,614,93840,28902720.0,93225,94556.0
769,37,30,10,17,114,113,151,150,89,265,263,17214,2280855.0,16950,17423.75
7690,98,81,27,59,216,215,267,266,462,483,481,57672,13927788.0,57190,58080.75
7691,83,64,24,59,255,254,171,170,439,426,424,43605,9287865.0,43180,45156.0
7692,47,39,13,25,174,173,161,160,148,335,333,28014,4692345.0,27680,27888.75
7693,118,104,28,52,253,252,328,327,625,581,579,82984,24106852.0,82404,84099.75
7694,125,113,32,54,240,239,233,232,460,473,471,55920,13225080.0,55448,55695.75
7695,124,111,29,53,257,256,170,169,287,427,425,43690,9327815.0,43264,45368.75
7696,36,30,14,21,172,171,297,296,502,469,467,51084,11979198.0,50616,54755.75
7697,69,48,21,57,134,133,131,130,116,265,263,17554,2325905.0,17290,17423.75
7698,117,90,35,84,237,236,274,273,537,511,509,64938,16591659.0,64428,65024.75
7699,81,68,28,52,157,156,155,154,127,312,310,24335,3796260.0,24024,24180.0
77,113,96,37,69,417,416,270,269,1554,687,685,112590,38674665.0,111904,117648.75
770,36,24,13,31,109,108,254,253,178,363,361,27686,5025009.0,27324,32760.75
7700,27,24,8,11,148,147,149,148,127,297,295,22052,3274722.0,21756,21903.75
7701,355,341,19,45,405,404,377,376,2182,782,780,152685,59699835.0,151904,152490.0
7702,59,58,18,18,254,253,137,136,184,391,389,34798,6803009.0,34408,38024.75
7703,53,49,14,20,123,122,103,102,109,226,224,12669,1431597.0,12444,12656.0
7704,78,69,28,43,253,252,238,237,441,491,489,60214,14782537.0,59724,60024.75
7705,32,27,13,21,136,135,114,113,84,250,248,15504,1938000.0,15255,15500.0
7707,56,42,15,34,118,117,126,125,106,244,242,14868,1813896.0,14625,14762.0
7708,150,121,42,96,282,281,385,384,1243,667,665,108570,36208095.0,107904,110888.75
7709,99,84,34,61,337,336,374,373,1463,711,709,126038,44806509.0,125328,126024.75
771,67,55,18,40,123,122,185,184,129,308,306,22755,3504270.0,22448,23562.0
7710,103,91,21,41,269,268,271,270,680,540,538,72899,19682730.0,72360,72630.0
7711,50,36,15,38,132,131,108,107,93,240,238,14256,1710720.0,14017,14280.0
7712,77,60,19,51,146,145,167,166,205,313,311,24382,3815783.0,24070,24335.75
7713,55,48,14,25,114,113,116,115,72,230,228,13224,1520760.0,12995,13110.0
7714,84,77,21,33,184,183,151,150,204,335,333,27784,4653820.0,27450,27888.75
7715,40,22,7,41,144,143,170,169,234,314,312,24480,3843360.0,24167,24492.0
7716,55,44,15,33,103,102,117,116,71,220,218,12051,1325610.0,11832,11990.0
7717,85,47,16,88,315,314,266,265,997,581,579,83790,24340995.0,83210,84099.75
7718,62,57,19,27,243,242,127,126,349,370,368,30861,5709285.0,30492,34040.0
7719,59,47,17,38,186,185,121,120,129,307,305,22506,3454671.0,22200,23408.75
772,36,31,15,23,124,123,108,107,53,232,230,13392,1553472.0,13161,13340.0
7720,60,52,20,34,194,193,113,112,120,307,305,21922,3365027.0,21616,23408.75
7721,92,74,29,61,215,214,263,262,458,478,476,56545,13514255.0,56068,56882.0
7722,133,130,8,12,147,146,147,146,111,294,292,21609,3176523.0,21316,21462.0
7723,84,67,23,55,203,202,221,220,373,424,422,44863,9510956.0,44440,44732.0
7724,64,59,16,24,174,173,166,165,263,340,338,28884,4910280.0,28545,28730.0
7725,33,32,8,8,110,109,145,144,98,255,253,15950,2033625.0,15696,16128.75
7726,112,89,26,70,282,281,267,266,731,549,547,75294,20668203.0,74746,75075.75
7727,48,44,11,16,160,159,94,93,85,254,252,15040,1910080.0,14787,16002.0
7728,37,33,10,16,131,130,122,121,124,253,251,15982,2021723.0,15730,15875.75
7729,68,63,13,20,188,187,92,91,97,280,278,17296,2421440.0,17017,19460.0
773,78,61,24,54,235,234,205,204,441,440,438,48175,10598500.0,47736,48180.0
7730,30,27,9,12,299,298,185,184,378,484,482,55315,13386230.0,54832,58322.0
7731,113,89,34,80,282,281,226,225,727,508,506,63732,16187928.0,63225,64262.0
7732,38,34,15,21,115,114,92,91,51,207,205,10580,1095030.0,10374,10608.75
7733,70,55,26,53,193,192,145,144,154,338,336,27985,4729465.0,27648,28392.0
7734,65,60,16,23,118,117,124,123,113,242,240,14632,1770472.0,14391,14520.0
7735,52,41,18,36,129,128,128,127,89,257,255,16512,2121792.0,16256,16383.75
7736,37,24,8,29,206,205,151,150,202,357,355,31106,5552421.0,30750,31683.75
7737,52,50,7,9,91,90,120,119,56,211,209,10920,1152060.0,10710,11024.75
7738,62,45,19,51,173,172,244,243,284,417,415,42212,8801202.0,41796,43263.75
774,55,49,18,27,248,247,412,411,1604,660,658,102176,33718080.0,101517,108570.0
7740,52,46,20,30,113,112,269,268,229,382,380,30397,5805827.0,30016,36290.0
7742,170,169,8,8,178,177,178,177,177,356,354,31684,5639752.0,31329,31506.0
7743,42,40,10,12,160,159,232,231,293,392,390,37120,7275520.0,36729,38220.0
7744,56,35,17,45,239,238,179,178,288,418,416,42781,8941229.0,42364,43472.0
7745,40,31,11,27,85,84,145,144,72,230,228,12325,1417375.0,12096,13110.0
7746,355,341,20,46,377,376,405,404,2398,782,780,152685,59699835.0,151904,152490.0
7747,40,37,13,17,83,82,93,92,45,176,174,7719,679272.0,7544,7656.0
7748,61,51,15,25,100,99,138,137,88,238,236,13800,1642200.0,13563,14042.0
7749,47,41,10,19,97,96,147,146,66,244,242,14259,1739598.0,14016,14762.0
775,74,63,21,41,159,158,179,178,275,338,336,28461,4809909.0,28124,28392.0
7750,63,61,17,19,198,197,126,125,165,324,322,24948,4041576.0,24625,26082.0
7751,95,86,28,43,342,341,188,187,458,530,528,64296,17038440.0,63767,69960.0
7752,53,43,14,30,150,149,238,237,213,388,386,35700,6925800.0,35313,37442.0
7753,56,43,13,37,121,120,115,114,106,236,234,13915,1641970.0,13680,13806.0
7754,20,17,6,9,104,103,166,165,96,270,268,17264,2330640.0,16995,18090.0
7755,34,24,7,25,109,108,156,155,99,265,263,17004,2253030.0,16740,17423.75
7756,68,56,24,40,217,216,307,306,432,524,522,66619,17454178.0,66096,68382.0
7757,48,34,19,41,151,150,131,130,115,282,280,19781,2789121.0,19500,19740.0
7759,52,46,15,25,145,144,143,142,138,288,286,20735,2985840.0,20448,20592.0
7760,69,55,16,38,222,221,136,135,282,358,356,30192,5404368.0,29835,31862.0
7761,48,43,15,23,153,152,173,172,140,326,324,26469,4314447.0,26144,26406.0
7762,73,66,20,32,139,138,126,125,78,265,263,17514,2320605.0,17250,17423.75
7764,71,61,20,36,128,127,136,135,98,264,262,17408,2297856.0,17145,17292.0
7765,56,51,22,30,161,160,134,133,105,295,293,21574,3182165.0,21280,21608.75
7766,76,49,26,76,268,267,366,365,1212,634,632,98088,31093896.0,97455,100172.0
7767,128,113,28,56,353,352,418,417,1785,771,769,147554,56882067.0,146784,148224.75
7768,127,105,44,83,381,380,531,530,3436,912,910,202311,92253816.0,201400,207480.0
7769,33,27,10,16,142,141,101,100,70,243,241,14342,1742553.0,14100,14640.75
777,50,45,14,22,134,133,217,216,207,351,349,29078,5103189.0,28728,30624.75
7770,78,65,22,45,141,140,224,223,256,365,363,31584,5764080.0,31220,33123.75
7771,21,18,6,8,76,75,87,86,26,163,161,6612,538878.0,6450,6560.75
7772,58,41,11,43,160,159,207,206,247,367,365,33120,6077520.0,32754,33488.75
7773,101,98,8,10,133,132,139,138,170,272,270,18487,2514232.0,18216,18360.0
7774,85,71,26,52,335,334,177,176,475,512,510,59295,15179520.0,58784,65280.0
7775,128,104,35,81,324,323,529,528,2892,853,851,171396,73100394.0,170544,181475.75
7776,75,68,25,37,201,200,166,165,192,367,365,33366,6122661.0,33000,33488.75
7777,58,36,15,55,155,154,136,135,163,291,289,21080,3067140.0,20790,21024.75
7778,94,84,22,38,168,167,152,151,218,320,318,25536,4085760.0,25217,25440.0
7779,42,34,12,23,258,257,114,113,212,372,370,29412,5470632.0,29041,34410.0
778,35,20,6,22,140,139,92,91,69,232,230,12880,1494080.0,12649,13340.0
7780,97,85,27,49,183,182,278,277,326,461,459,50874,11726457.0,50414,52899.75
7781,74,55,24,56,193,192,174,173,235,367,365,33582,6162297.0,33216,33488.75
7782,114,99,37,65,346,345,267,266,793,613,611,92382,28315083.0,91770,93635.75
7784,138,116,32,73,270,269,263,262,493,533,531,71010,18924165.0,70478,70755.75
7785,58,52,19,29,155,154,140,139,146,295,293,21700,3200750.0,21406,21608.75
7786,39,35,10,16,77,76,128,127,45,205,203,9856,1010240.0,9652,10403.75
7787,71,62,24,40,328,327,401,400,1172,729,727,131528,47941956.0,130800,132495.75
7788,79,59,25,62,290,289,219,218,506,509,507,63510,16163295.0,63002,64515.75
7789,47,44,12,16,182,181,109,108,96,291,289,19838,2886429.0,19548,21024.75
779,64,50,18,44,139,138,156,155,122,295,293,21684,3198390.0,21390,21608.75
7790,70,48,18,59,344,343,208,207,711,552,550,71552,19748352.0,71001,75900.0
7791,64,58,20,30,164,163,152,151,124,316,314,24928,3938624.0,24613,24806.0
7792,44,37,11,22,102,101,143,142,77,245,243,14586,1786785.0,14342,14883.75
7793,49,43,13,22,146,145,102,101,101,248,246,14892,1846608.0,14645,15252.0
7794,77,60,22,53,119,118,261,260,203,380,378,31059,5901210.0,30680,35910.0
7795,49,44,17,25,206,205,214,213,288,420,418,44084,9257640.0,43665,43890.0
7796,53,43,19,37,147,146,205,204,248,352,350,30135,5303760.0,29784,30800.0
7797,120,119,5,5,124,123,147,146,92,271,269,18228,2469894.0,17958,18224.75
7798,73,57,25,55,223,222,255,254,448,478,476,56865,13590735.0,56388,56882.0
7799,41,31,11,21,254,253,212,211,435,466,464,53848,12546584.0,53383,54056.0
78,92,83,25,41,162,161,158,157,123,320,318,25596,4095360.0,25277,25440.0
780,38,37,9,9,109,108,83,82,36,192,190,9047,868512.0,8856,9120.0
7800,89,77,26,46,162,161,185,184,252,347,345,29970,5199795.0,29624,29928.75
7801,68,58,18,35,139,138,120,119,99,259,257,16680,2160060.0,16422,16640.75
7802,52,46,14,22,195,194,112,111,182,307,305,21840,3352440.0,21534,23408.75
7803,66,62,22,28,157,156,139,138,125,296,294,21823,3229804.0,21528,21756.0
7804,112,98,27,51,192,191,198,197,237,390,388,38016,7413120.0,37627,37830.0
7805,44,35,12,26,138,137,101,100,75,239,237,13938,1665591.0,13700,14160.75
7806,31,29,11,12,247,246,167,166,345,414,412,41249,8538543.0,40836,42642.0
7807,20,17,5,7,282,281,126,125,275,408,406,35532,7248528.0,35125,41412.0
7809,49,41,11,21,146,145,121,120,82,267,265,17666,2358411.0,17400,17688.75
781,42,35,10,22,235,234,126,125,202,361,359,29610,5344605.0,29250,32399.75
7810,60,48,18,37,116,115,179,178,110,295,293,20764,3062690.0,20470,21608.75
7811,52,48,18,24,114,113,143,142,80,257,255,16302,2094807.0,16046,16383.75
7813,37,30,9,21,168,167,129,128,112,297,295,21672,3218292.0,21376,21903.75
7814,101,87,25,51,190,189,155,154,169,345,343,29450,5080125.0,29106,29583.75
7815,79,64,21,49,150,149,210,209,232,360,358,31500,5670000.0,31141,32220.0
7816,53,44,15,31,134,133,104,103,93,238,236,13936,1658384.0,13699,14042.0
7817,61,53,16,29,162,161,97,96,85,259,257,15714,2034963.0,15456,16640.75
7818,43,37,18,27,210,209,213,212,252,423,421,44730,9460395.0,44308,44520.75
7819,38,32,13,23,77,76,120,119,42,197,195,9240,910140.0,9044,9603.75
782,54,43,16,34,210,209,159,158,172,369,367,33390,6160455.0,33022,33855.75
7820,86,71,33,61,161,160,205,204,250,366,364,33005,6039915.0,32640,33306.0
7821,69,58,16,34,127,126,133,132,95,260,258,16891,2195830.0,16632,16770.0
7822,96,68,25,76,195,194,202,201,276,397,395,39390,7818915.0,38994,39203.75
7823,93,85,21,35,144,143,247,246,244,391,389,35568,6953544.0,35178,38024.75
7824,60,49,20,36,394,393,348,347,2500,742,740,137112,50868552.0,136371,137270.0
7825,73,64,26,42,230,229,454,453,1271,684,682,104420,35711640.0,103737,116622.0
7826,30,25,9,15,103,102,166,165,110,269,267,17098,2299681.0,16830,17955.75
7827,49,40,17,30,170,169,120,119,126,290,288,20400,2958000.0,20111,20880.0
7828,162,127,41,107,395,394,371,370,2305,766,764,146545,56126735.0,145780,146306.0
7829,56,48,15,29,110,109,208,207,187,318,316,22880,3637920.0,22563,25122.0
783,53,41,17,37,130,129,200,199,150,330,328,26000,4290000.0,25671,27060.0
7830,20,17,6,8,410,409,268,267,740,678,676,109880,37249320.0,109203,114582.0
7831,72,56,22,48,328,327,214,213,533,542,540,70192,19022032.0,69651,73170.0
7832,34,28,11,17,328,327,183,182,387,511,509,60024,15336132.0,59514,65024.75
7833,70,61,22,38,179,178,241,240,318,420,418,43139,9059190.0,42720,43890.0
7834,108,96,35,57,391,390,288,287,1518,679,677,112608,38230416.0,111930,114920.75
7835,65,55,25,43,134,133,229,228,240,363,361,30686,5569509.0,30324,32760.75
7837,66,57,19,35,180,179,124,123,108,304,302,22320,3392640.0,22017,22952.0
7838,106,81,37,85,515,514,197,196,838,712,710,101455,36117980.0,100744,126380.0
7839,32,29,8,12,114,113,158,157,118,272,270,18012,2449632.0,17741,18360.0
784,41,38,14,18,122,121,150,149,104,272,270,18300,2488800.0,18029,18360.0
7840,28,26,10,12,224,223,80,79,126,304,302,17920,2723840.0,17617,22952.0
7841,49,41,18,30,145,144,192,191,168,337,335,27840,4691040.0,27504,28223.75
7842,84,69,29,57,278,277,153,152,278,431,429,42534,9166077.0,42104,46224.75
7843,65,59,17,24,243,242,173,172,268,416,414,42039,8744112.0,41624,43056.0
7844,72,62,24,42,296,295,261,260,536,557,555,77256,21515796.0,76700,77283.75
7845,70,56,23,47,207,206,142,141,177,349,347,29394,5129253.0,29046,30275.75
7846,64,45,15,45,141,140,134,133,103,275,273,18894,2597925.0,18620,18768.75
7847,55,47,14,28,99,98,180,179,100,279,277,17820,2485890.0,17542,19320.75
7848,137,116,32,70,242,241,507,506,1324,749,747,122694,45948903.0,121946,139875.75
7849,73,64,14,30,206,205,131,130,229,337,335,26986,4547141.0,26650,28223.75
785,61,48,18,37,165,164,120,119,90,285,283,19800,2821500.0,19516,20163.75
7850,82,68,24,50,294,293,299,298,692,593,591,87906,26064129.0,87314,87615.75
7851,56,45,11,31,142,141,134,133,116,276,274,19028,2625864.0,18753,18906.0
7852,86,79,17,29,264,263,166,165,351,430,428,43824,9422160.0,43395,46010.0
7853,44,39,11,18,97,96,100,99,49,197,195,9700,955450.0,9504,9603.75
7854,57,52,15,21,170,169,170,169,179,340,338,28900,4913000.0,28561,28730.0
7855,74,67,21,32,250,249,303,302,577,553,551,75750,20944875.0,75198,76175.75
7856,62,54,18,32,425,424,384,383,1889,809,807,163200,66014400.0,162392,163215.75
7857,49,44,15,23,125,124,210,209,145,335,333,26250,4396875.0,25916,27888.75
7858,85,66,21,56,155,154,174,173,174,329,327,26970,4436565.0,26642,26895.75
786,21,19,6,8,124,123,84,83,49,208,206,10416,1083264.0,10209,10712.0
7861,63,54,21,37,171,170,135,134,152,306,304,23085,3532005.0,22780,23256.0
7863,36,33,10,14,150,149,190,189,132,340,338,28500,4845000.0,28161,28730.0
7864,46,36,18,35,160,159,181,180,152,341,339,28960,4937680.0,28620,28899.75
7865,45,34,8,19,103,102,161,160,81,264,262,16583,2188956.0,16320,17292.0
7866,73,63,18,34,188,187,143,142,163,331,329,26884,4449302.0,26554,27224.75
7867,390,382,13,27,405,404,405,404,3055,810,808,164025,66430125.0,163216,163620.0
7868,79,70,17,33,160,159,138,137,107,298,296,22080,3289920.0,21783,22052.0
7869,74,66,18,32,124,123,115,114,105,239,237,14260,1704070.0,14022,14160.75
7870,45,40,12,18,168,167,209,208,227,377,375,35112,6618612.0,34736,35343.75
7871,68,60,18,32,161,160,136,135,124,297,295,21896,3251556.0,21600,21903.75
7872,64,51,22,45,179,178,146,145,191,325,323,26134,4246775.0,25810,26243.75
7873,30,24,10,18,133,132,174,173,172,307,305,23142,3552297.0,22836,23408.75
7874,72,63,20,36,158,157,216,215,191,374,372,34128,6381936.0,33755,34782.0
7875,53,49,14,17,141,140,147,146,124,288,286,20727,2984688.0,20440,20592.0
7876,55,48,14,26,231,230,114,113,182,345,343,26334,4542615.0,25990,29583.75
7877,55,51,17,23,83,82,140,139,65,223,221,11620,1295630.0,11398,12320.75
7878,39,28,14,34,122,121,136,135,91,258,256,16592,2140368.0,16335,16512.0
7879,68,54,20,45,138,137,110,109,76,248,246,15180,1882320.0,14933,15252.0
788,74,53,25,62,463,462,310,309,1428,773,771,143530,55474345.0,142758,148995.75
7880,34,26,11,25,145,144,283,282,413,428,426,41035,8781490.0,40608,45582.0
7881,43,37,10,18,195,194,109,108,114,304,302,21255,3230760.0,20952,22952.0
7882,63,49,21,46,167,166,299,298,518,466,464,49933,11634389.0,49468,54056.0
7883,40,29,16,33,88,87,104,103,39,192,190,9152,878592.0,8961,9120.0
7884,54,47,15,25,92,91,103,102,55,195,193,9476,923910.0,9282,9408.75
7885,60,48,15,35,119,118,196,195,121,315,313,23324,3673530.0,23010,24648.75
7886,90,76,25,50,261,260,210,209,326,471,469,54810,12907755.0,54340,55224.75
7887,69,60,22,38,137,136,149,148,135,286,284,20413,2919059.0,20128,20306.0
7888,40,33,10,19,132,131,144,143,134,276,274,19008,2623104.0,18733,18906.0
7889,57,48,15,29,86,85,109,108,33,195,193,9374,913965.0,9180,9408.75
789,49,31,16,49,140,139,180,179,160,320,318,25200,4032000.0,24881,25440.0
7890,45,37,16,24,172,171,113,112,108,285,283,19436,2769630.0,19152,20163.75
7891,76,65,24,42,240,239,229,228,504,469,467,54960,12888120.0,54492,54755.75
7892,67,56,27,46,245,244,368,367,952,613,611,90160,27634040.0,89548,93635.75
7893,90,70,28,64,193,192,173,172,213,366,364,33389,6110187.0,33024,33306.0
7894,139,121,41,75,244,243,265,264,496,509,507,64660,16455970.0,64152,64515.75
7895,70,64,18,28,200,199,121,120,143,321,319,24200,3884100.0,23880,25599.75
7896,99,86,20,43,180,179,146,145,169,326,324,26280,4283640.0,25955,26406.0
7897,30,16,7,32,179,178,115,114,144,294,292,20585,3025995.0,20292,21462.0
7899,79,61,21,46,176,175,146,145,186,322,320,25696,4137056.0,25375,25760.0
79,43,40,16,20,225,224,116,115,142,341,339,26100,4450050.0,25760,28899.75
790,57,56,7,7,82,81,125,124,61,207,205,10250,1060875.0,10044,10608.75
7900,87,63,34,77,232,231,260,259,698,492,490,60320,14838720.0,59829,60270.0
7901,58,51,21,33,158,157,268,267,360,426,424,42344,9019272.0,41919,45156.0
7902,68,47,18,58,157,156,138,137,142,295,293,21666,3195735.0,21372,21608.75
7903,45,36,11,27,111,110,120,119,65,231,229,13320,1538460.0,13090,13224.75
7904,52,44,19,32,208,207,529,528,1509,737,735,110032,40546792.0,109296,135423.75
7905,67,58,19,32,220,219,171,170,307,391,389,37620,7354710.0,37230,38024.75
7907,93,70,27,69,221,220,215,214,401,436,434,47515,10358270.0,47080,47306.0
7908,30,20,4,14,150,149,167,166,259,317,315,25050,3970425.0,24734,24963.75
7909,28,24,10,16,137,136,107,106,94,244,242,14659,1788398.0,14416,14762.0
791,60,51,20,34,117,116,319,318,388,436,434,37323,8136414.0,36888,47306.0
7910,83,67,29,57,211,210,192,191,273,403,401,40512,8163168.0,40110,40400.75
7911,91,77,10,27,152,151,126,125,123,278,276,19152,2662128.0,18875,19182.0
7912,86,70,27,57,166,165,163,162,156,329,327,27058,4451041.0,26730,26895.75
7913,63,49,16,41,223,222,220,219,516,443,441,49060,10866790.0,48618,48840.75
7914,54,44,22,39,138,137,149,148,125,287,285,20562,2950647.0,20276,20448.75
7915,46,39,11,23,142,141,100,99,95,242,240,14200,1718200.0,13959,14520.0
7916,54,42,15,32,222,221,99,98,149,321,319,21978,3527469.0,21658,25599.75
7917,69,62,18,29,192,191,124,123,117,316,314,23808,3761664.0,23493,24806.0
7918,37,23,13,38,97,96,99,98,63,196,194,9603,941094.0,9408,9506.0
7919,58,52,15,21,97,96,108,107,70,205,203,10476,1073790.0,10272,10403.75
792,257,256,10,10,267,266,267,266,577,534,532,71289,19034163.0,70756,71022.0
7920,55,49,13,23,141,140,76,75,47,217,215,10716,1162686.0,10500,11663.75
7921,45,38,13,21,166,165,115,114,101,281,279,19090,2682145.0,18810,19599.75
7922,149,120,46,101,352,351,357,356,1599,709,707,125664,44547888.0,124956,125315.75
7923,58,50,16,28,86,85,97,96,52,183,181,8342,763293.0,8160,8280.75
7924,57,50,21,32,204,203,161,160,184,365,363,32844,5994030.0,32480,33123.75
7925,23,18,10,16,135,134,122,121,127,257,255,16470,2116395.0,16214,16383.75
7926,51,39,14,35,117,116,169,168,132,286,284,19773,2827539.0,19488,20306.0
7927,83,64,19,51,126,125,162,161,149,288,286,20412,2939328.0,20125,20592.0
7928,47,39,13,26,287,286,175,174,433,462,460,50225,11601975.0,49764,53130.0
7929,43,33,16,33,117,116,117,116,83,234,232,13689,1601613.0,13456,13572.0
793,53,44,20,36,386,385,217,216,866,603,601,83762,25254243.0,83160,90600.75
7930,140,107,43,107,515,514,292,291,1884,807,805,150380,60678330.0,149574,162408.75
7931,44,41,11,15,145,144,133,132,83,278,276,19285,2680615.0,19008,19182.0
7932,46,39,15,24,83,82,186,185,91,269,267,15438,2076411.0,15170,17955.75
7933,60,53,21,33,132,131,161,160,130,293,291,21252,3113418.0,20960,21315.75
7934,76,65,21,41,151,150,130,129,114,281,279,19630,2758015.0,19350,19599.75
7935,130,99,42,101,459,458,290,289,1237,749,747,133110,49849695.0,132362,139875.75
7936,37,35,9,11,122,121,116,115,66,238,236,14152,1684088.0,13915,14042.0
7937,68,60,22,34,156,155,151,150,120,307,305,23556,3615846.0,23250,23408.75
7938,66,48,23,54,359,358,146,145,405,505,503,52414,13234535.0,51910,63503.75
7939,64,56,19,33,185,184,499,498,805,684,682,92315,31571730.0,91632,116622.0
794,64,60,12,18,91,90,127,126,53,218,216,11557,1259713.0,11340,11772.0
7940,33,27,14,24,162,161,241,240,272,403,401,39042,7866963.0,38640,40400.75
7941,76,62,35,61,194,193,307,306,971,501,499,59558,14919279.0,59058,62499.75
7942,38,33,14,22,96,95,151,150,61,247,245,14496,1790256.0,14250,15128.75
7943,31,26,10,17,222,221,137,136,197,359,357,30414,5459313.0,30056,32040.75
7944,50,38,12,34,132,131,99,98,103,231,229,13068,1509354.0,12838,13224.75
7945,119,100,37,72,455,454,275,274,1355,730,728,125125,45670625.0,124396,132860.0
7946,40,37,13,17,113,112,211,210,132,324,322,23843,3862566.0,23520,26082.0
7947,90,74,22,51,352,351,304,303,1676,656,654,107008,35098624.0,106353,107256.0
7948,26,22,6,11,232,231,112,111,310,344,342,25984,4469248.0,25641,29412.0
7949,26,22,8,12,195,194,310,309,357,505,503,60450,15263625.0,59946,63503.75
795,69,57,25,47,161,160,115,114,116,276,274,18515,2555070.0,18240,18906.0
7950,64,48,19,43,106,105,228,227,160,334,332,24168,4036056.0,23835,27722.0
7951,44,39,18,25,132,131,113,112,89,245,243,14916,1827210.0,14672,14883.75
7952,78,59,23,59,204,203,218,217,485,422,420,44472,9383592.0,44051,44310.0
7953,92,72,30,68,291,290,179,178,485,470,468,52089,12240915.0,51620,54990.0
7954,50,46,15,20,230,229,120,119,160,350,348,27600,4830000.0,27251,30450.0
7955,60,52,19,33,127,126,114,113,82,241,239,14478,1744599.0,14238,14399.75
7956,84,70,21,47,141,140,219,218,263,360,358,30879,5558220.0,30520,32220.0
7957,54,42,14,36,87,86,116,115,51,203,201,10092,1024338.0,9890,10200.75
7959,92,72,26,63,297,296,225,224,637,522,520,66825,17441325.0,66304,67860.0
796,42,26,8,34,126,125,147,146,123,273,271,18522,2528253.0,18250,18495.75
7960,87,72,24,52,269,268,231,230,757,500,498,62139,15534750.0,61640,62250.0
7961,88,76,29,51,227,226,350,349,847,577,575,79450,22921325.0,78874,82943.75
7962,46,37,11,26,112,111,98,97,50,210,208,10976,1152480.0,10767,10920.0
7963,35,27,11,25,132,131,93,92,65,225,223,12276,1381050.0,12052,12543.75
7964,26,24,10,12,220,219,141,140,176,361,359,31020,5599110.0,30660,32399.75
7965,21,18,7,10,81,80,82,81,39,163,161,6642,541323.0,6480,6560.75
7966,54,40,21,46,184,183,285,284,425,469,467,52440,12297180.0,51972,54755.75
7967,19,16,6,9,129,128,142,141,87,271,269,18318,2482089.0,18048,18224.75
7968,45,42,14,18,145,144,83,82,53,228,226,12035,1371990.0,11808,12882.0
7969,70,58,16,33,135,134,181,180,229,316,314,24435,3860730.0,24120,24806.0
797,101,85,35,63,337,336,238,237,758,575,573,80206,23059225.0,79632,82368.75
7970,57,52,18,26,91,90,147,146,97,238,236,13377,1591863.0,13140,14042.0
7971,51,36,11,38,155,154,118,117,102,273,271,18290,2496585.0,18018,18495.75
7972,123,99,32,77,250,249,279,278,646,529,527,69750,18448875.0,69222,69695.75
7973,125,99,47,93,523,522,530,529,4892,1053,1051,277190,145940535.0,276138,276675.75
7974,95,75,32,70,221,220,292,291,621,513,511,64532,16552458.0,64020,65535.75
7975,107,87,34,72,250,249,341,340,913,591,589,85250,25191375.0,84660,87024.75
7977,106,79,33,85,271,270,304,303,864,575,573,82384,23685400.0,81810,82368.75
7978,47,31,14,41,131,130,128,127,85,259,257,16768,2171456.0,16510,16640.75
7979,79,71,20,33,213,212,124,123,142,337,335,26412,4450422.0,26076,28223.75
798,20,19,6,6,80,79,119,118,43,199,197,9520,947240.0,9322,9800.75
7980,42,38,8,14,104,103,92,91,40,196,194,9568,937664.0,9373,9506.0
7981,42,35,11,23,97,96,89,88,39,186,184,8633,802869.0,8448,8556.0
7982,66,54,20,40,411,410,257,256,792,668,666,105627,35279418.0,104960,111222.0
7983,23,21,8,10,248,247,75,74,100,323,321,18600,3003900.0,18278,25920.75
7984,51,49,4,6,194,193,74,73,68,268,266,14356,1923704.0,14089,17822.0
7985,127,100,36,88,304,303,306,305,854,610,608,93024,28372320.0,92415,92720.0
7986,65,49,21,46,173,172,194,193,328,367,365,33562,6158627.0,33196,33488.75
7987,35,25,8,22,118,117,95,94,57,213,211,11210,1193865.0,10998,11235.75
7988,37,31,5,12,150,149,106,105,93,256,254,15900,2035200.0,15645,16256.0
7989,16,15,4,4,98,97,107,106,42,205,203,10486,1074815.0,10282,10403.75
799,48,42,18,27,111,110,136,135,122,247,245,15096,1864356.0,14850,15128.75
7990,86,69,21,53,321,320,139,138,356,460,458,44619,10262370.0,44160,52670.0
7991,38,32,12,19,123,122,238,237,197,361,359,29274,5283957.0,28914,32399.75
7992,89,78,23,43,396,395,195,194,553,591,589,77220,22818510.0,76630,87024.75
7993,50,34,16,44,169,168,252,251,358,421,419,42588,8964774.0,42168,44099.75
7994,49,41,14,28,115,114,131,130,70,246,244,15065,1852995.0,14820,15006.0
7995,76,69,18,30,128,127,127,126,72,255,253,16256,2072640.0,16002,16128.75
7996,101,84,32,63,266,265,313,312,878,579,577,83258,24103191.0,82680,83520.75
7997,66,50,15,43,191,190,155,154,319,346,344,29605,5121665.0,29260,29756.0
7999,55,46,19,34,216,215,155,154,204,371,369,33480,6210540.0,33110,34224.75
8,49,42,16,26,114,113,259,258,215,373,371,29526,5506599.0,29154,34595.75
80,67,50,15,47,137,136,154,153,139,291,289,21098,3069759.0,20808,21024.75
800,61,58,13,17,104,103,137,136,70,241,239,14248,1716884.0,14008,14399.75
8000,69,54,16,43,179,178,245,244,315,424,422,43855,9297260.0,43432,44732.0
8001,94,85,18,34,145,144,146,145,113,291,289,21170,3080235.0,20880,21024.75
8002,126,109,49,80,443,442,350,349,2450,793,791,155050,61477325.0,154258,156815.75
8003,54,44,20,33,175,174,127,126,149,302,300,22225,3355975.0,21924,22650.0
8004,87,72,28,54,248,247,156,155,213,404,402,38688,7814976.0,38285,40602.0
8005,47,32,14,34,127,126,150,149,119,277,275,19050,2638425.0,18774,19043.75
8006,34,28,9,17,117,116,76,75,39,193,191,8892,858078.0,8700,9215.75
8007,128,98,48,105,410,409,428,427,2839,838,836,175480,73526120.0,174643,175142.0
8008,58,50,18,32,208,207,106,105,132,314,312,22048,3461536.0,21735,24492.0
8009,35,30,14,22,267,266,79,78,161,346,344,21093,3649089.0,20748,29756.0
801,78,63,31,58,168,167,267,266,385,435,433,44856,9756180.0,44422,47088.75
8010,123,115,12,26,178,177,147,146,183,325,323,26166,4251975.0,25842,26243.75
8011,100,80,36,72,350,349,186,185,539,536,534,65100,17446800.0,64565,71556.0
8012,39,35,13,19,95,94,241,240,163,336,334,22895,3846360.0,22560,28056.0
8013,52,42,19,36,231,230,166,165,349,397,395,38346,7611681.0,37950,39203.75
8014,47,38,15,29,94,93,94,93,60,188,186,8836,830584.0,8649,8742.0
8015,41,31,8,26,112,111,177,176,172,289,287,19824,2864568.0,19536,20735.75
8016,75,55,18,54,173,172,180,179,256,353,351,31140,5496210.0,30788,30975.75
8017,30,25,11,17,312,311,110,109,225,422,420,34320,7241520.0,33899,44310.0
8018,56,42,18,39,161,160,248,247,330,409,407,39928,8165276.0,39520,41615.75
8019,42,35,16,28,174,173,83,82,79,257,255,14442,1855797.0,14186,16383.75
802,100,88,25,45,230,229,220,219,433,450,448,50600,11385000.0,50151,50400.0
8020,28,18,7,16,103,102,117,116,82,220,218,12051,1325610.0,11832,11990.0
8021,37,33,9,13,123,122,128,127,79,251,249,15744,1975872.0,15494,15624.75
8022,31,29,12,14,78,77,275,274,129,353,351,21450,3785925.0,21098,30975.75
8023,67,49,16,48,133,132,135,134,121,268,266,17955,2405970.0,17688,17822.0
8024,41,37,16,21,140,139,122,121,66,262,260,17080,2237480.0,16819,17030.0
8025,85,75,24,42,167,166,141,140,119,308,306,23547,3626238.0,23240,23562.0
8026,55,48,15,26,125,124,117,116,83,242,240,14625,1769625.0,14384,14520.0
8027,29,25,10,16,129,128,131,130,98,260,258,16899,2196870.0,16640,16770.0
8028,133,104,44,100,243,242,443,442,1070,686,684,107649,36923607.0,106964,117306.0
8029,42,22,5,34,115,114,100,99,84,215,213,11500,1236250.0,11286,11448.75
803,54,48,14,24,112,111,85,84,50,197,195,9520,937720.0,9324,9603.75
8030,48,31,15,47,112,111,129,128,84,241,239,14448,1740984.0,14208,14399.75
8031,25,22,8,11,179,178,147,146,150,326,324,26313,4289019.0,25988,26406.0
8032,41,35,13,22,154,153,107,106,88,261,259,16478,2150379.0,16218,16899.75
8033,30,24,8,17,76,75,130,129,65,206,204,9880,1017640.0,9675,10506.0
8034,109,92,31,62,284,283,204,203,583,488,486,57936,14136384.0,57449,59292.0
8036,80,66,23,49,180,179,208,207,376,388,386,37440,7263360.0,37053,37442.0
8038,119,117,8,10,193,192,147,146,161,340,338,28371,4823070.0,28032,28730.0
8039,47,39,16,25,217,216,192,191,330,409,407,41664,8520288.0,41256,41615.75
804,50,37,10,34,77,76,186,185,93,263,261,14322,1883343.0,14060,17160.75
8040,28,17,5,15,234,233,92,91,145,326,324,21528,3509064.0,21203,26406.0
8041,27,25,6,8,124,123,86,85,43,210,208,10664,1119720.0,10455,10920.0
8042,39,34,15,23,155,154,208,207,187,363,361,32240,5851560.0,31878,32760.75
8043,82,70,24,45,155,154,198,197,234,353,351,30690,5416785.0,30338,30975.75
8044,60,53,14,26,112,111,164,163,72,276,274,18368,2534784.0,18093,18906.0
8045,63,54,22,37,107,106,120,119,65,227,225,12840,1457340.0,12614,12768.75
8046,68,61,20,32,215,214,125,124,177,340,338,26875,4568750.0,26536,28730.0
8047,45,38,17,29,196,195,110,109,136,306,304,21560,3298680.0,21255,23256.0
8048,34,30,13,19,285,284,137,136,226,422,420,39045,8238495.0,38624,44310.0
8049,107,88,41,76,366,365,433,432,2438,799,797,158478,63311961.0,157680,159200.75
805,51,35,15,42,213,212,175,174,236,388,386,37275,7231350.0,36888,37442.0
8050,70,49,18,57,184,183,173,172,235,357,355,31832,5682012.0,31476,31683.75
8051,71,52,19,55,171,170,122,121,116,293,291,20862,3056283.0,20570,21315.75
8052,57,44,20,42,158,157,165,164,206,323,321,26070,4210305.0,25748,25920.75
8053,155,125,43,99,535,534,380,379,2912,915,913,203300,93009750.0,202386,208848.75
8054,27,23,8,12,153,152,118,117,109,271,269,18054,2446317.0,17784,18224.75
8056,33,32,9,9,133,132,143,142,106,276,274,19019,2624622.0,18744,18906.0
8057,64,57,18,30,159,158,118,117,117,277,275,18762,2598537.0,18486,19043.75
8058,58,53,16,23,188,187,161,160,168,349,347,30268,5281766.0,29920,30275.75
8059,116,90,36,85,254,253,298,297,573,552,550,75692,20890992.0,75141,75900.0
806,88,64,25,70,332,331,362,361,1195,694,692,120184,41703848.0,119491,120062.0
8060,126,110,41,69,327,326,318,317,1271,645,643,103986,33535485.0,103342,103683.75
8061,44,35,16,32,163,162,185,184,199,348,346,30155,5246970.0,29808,30102.0
8062,69,63,14,22,191,190,114,113,102,305,303,21774,3320535.0,21470,23103.75
8063,78,69,16,32,133,132,102,101,60,235,233,13566,1594005.0,13332,13688.75
8064,39,33,17,27,135,134,300,299,283,435,433,40500,8808750.0,40066,47088.75
8065,22,21,6,6,222,221,216,215,333,438,436,47952,10501488.0,47515,47742.0
8066,37,30,10,21,88,87,126,125,72,214,212,11088,1186416.0,10875,11342.0
8067,58,44,13,35,101,100,123,122,68,224,222,12423,1391376.0,12200,12432.0
8068,103,81,32,71,228,227,241,240,450,469,467,54948,12885306.0,54480,54755.75
8069,57,49,17,27,166,165,175,174,241,341,339,29050,4953025.0,28710,28899.75
807,110,90,30,65,246,245,193,192,347,439,437,47478,10421421.0,47040,47960.75
8070,39,31,12,24,122,121,116,115,82,238,236,14152,1684088.0,13915,14042.0
8071,67,55,19,41,157,156,118,117,106,275,273,18526,2547325.0,18252,18768.75
8072,20,18,5,7,440,439,162,161,758,602,600,71280,21455280.0,70679,90300.0
8073,63,59,15,21,205,204,92,91,109,297,295,18860,2800710.0,18564,21903.75
8075,105,89,34,64,377,376,343,342,1276,720,718,129311,46551960.0,128592,129240.0
8076,54,47,12,21,127,126,157,156,151,284,282,19939,2831338.0,19656,20022.0
8077,32,29,11,14,431,430,155,154,637,586,584,66805,19573865.0,66220,85556.0
8078,80,70,22,40,214,213,166,165,189,380,378,35524,6749560.0,35145,35910.0
8079,74,52,25,66,176,175,207,206,233,383,381,36432,6976728.0,36050,36480.75
808,59,49,14,32,160,159,150,149,118,310,308,24000,3720000.0,23691,23870.0
8080,49,41,16,30,136,135,190,189,192,326,324,25840,4211920.0,25515,26406.0
8081,60,48,22,43,161,160,231,230,368,392,390,37191,7289436.0,36800,38220.0
8082,64,60,14,19,155,154,147,146,134,302,300,22785,3440535.0,22484,22650.0
8083,80,62,27,59,224,223,172,171,343,396,394,38528,7628544.0,38133,39006.0
8084,62,54,19,30,164,163,123,122,101,287,285,20172,2894682.0,19886,20448.75
8085,30,25,5,10,115,114,88,87,38,203,201,10120,1027180.0,9918,10200.75
8086,54,43,20,40,204,203,101,100,128,305,303,20604,3142110.0,20300,23103.75
8087,70,64,13,23,108,107,147,146,130,255,253,15876,2024190.0,15622,16128.75
8088,32,28,10,15,115,114,110,109,65,225,223,12650,1423125.0,12426,12543.75
8089,130,111,34,70,273,272,292,291,584,565,563,79716,22519770.0,79152,79523.75
809,78,64,19,45,136,135,140,139,102,276,274,19040,2627520.0,18765,18906.0
8090,59,52,22,33,178,177,134,133,155,312,310,23852,3720912.0,23541,24180.0
8091,66,54,20,41,246,245,137,136,239,383,381,33702,6453933.0,33320,36480.75
8092,63,51,21,43,106,105,134,133,109,240,238,14204,1704480.0,13965,14280.0
8093,71,61,17,35,134,133,137,136,89,271,269,18358,2487509.0,18088,18224.75
8094,44,34,13,28,121,120,142,141,103,263,261,17182,2259433.0,16920,17160.75
8095,56,36,5,41,193,192,123,122,232,316,314,23739,3750762.0,23424,24806.0
8096,17,15,5,7,196,195,195,194,225,391,389,38220,7472010.0,37830,38024.75
8097,64,49,20,47,199,198,166,165,200,365,363,33034,6028705.0,32670,33123.75
8098,58,44,17,38,122,121,155,154,148,277,275,18910,2619035.0,18634,19043.75
8099,36,24,14,31,144,143,102,101,85,246,244,14688,1806624.0,14443,15006.0
81,32,27,13,21,151,150,157,156,126,308,306,23707,3650878.0,23400,23562.0
810,46,35,12,24,87,86,73,72,35,160,158,6351,508080.0,6192,6320.0
8100,84,77,23,35,200,199,166,165,239,366,364,33200,6075600.0,32835,33306.0
8101,74,67,24,34,514,513,281,280,1332,795,793,144434,57412515.0,143640,157608.75
8102,50,40,15,26,143,142,156,155,133,299,297,22308,3335046.0,22010,22200.75
8103,91,77,27,49,277,276,273,272,639,550,548,75621,20795775.0,75072,75350.0
8104,56,48,15,29,115,114,174,173,115,289,287,20010,2891445.0,19722,20735.75
8105,46,36,16,31,125,124,295,294,258,420,418,36875,7743750.0,36456,43890.0
8106,119,118,6,6,170,169,147,146,131,317,315,24990,3960915.0,24674,24963.75
8107,52,41,17,34,270,269,370,369,900,640,638,99900,31968000.0,99261,102080.0
8108,32,26,13,21,247,246,187,186,289,434,432,46189,10023013.0,45756,46872.0
8109,49,42,17,28,441,440,259,258,905,700,698,114219,39976650.0,113520,122150.0
811,26,24,7,8,151,150,159,158,123,310,308,24009,3721395.0,23700,23870.0
8110,22,19,7,9,144,143,131,130,118,275,273,18864,2593800.0,18590,18768.75
8111,45,41,15,20,93,92,113,112,49,206,204,10509,1082427.0,10304,10506.0
8112,81,68,26,45,209,208,233,232,320,442,440,48697,10762037.0,48256,48620.0
8113,93,86,27,39,268,267,189,188,491,457,455,50652,11573982.0,50196,51983.75
8114,133,116,38,70,267,266,259,258,691,526,524,69153,18187239.0,68628,68906.0
8115,48,37,15,34,119,118,156,155,108,275,273,18564,2552550.0,18290,18768.75
8116,112,93,26,62,180,179,177,176,253,357,355,31860,5687010.0,31504,31683.75
8117,84,65,31,65,172,171,309,308,401,481,479,53148,12782094.0,52668,57599.75
8118,118,100,40,73,422,421,491,490,3933,913,911,207202,94587713.0,206290,207935.75
8119,72,54,21,54,189,188,314,313,742,503,501,59346,14925519.0,58844,63000.75
812,39,33,11,21,96,95,124,123,61,220,218,11904,1309440.0,11685,11990.0
8120,86,74,28,50,234,233,203,202,303,437,435,47502,10379187.0,47066,47523.75
8121,67,59,19,31,130,129,168,167,143,298,296,21840,3254160.0,21543,22052.0
8122,119,114,12,20,178,177,147,146,192,325,323,26166,4251975.0,25842,26243.75
8123,122,110,24,45,247,246,250,249,452,497,495,61750,15344875.0,61254,61503.75
8124,104,87,33,65,239,238,279,278,772,518,516,66681,17270379.0,66164,66822.0
8125,25,22,5,9,87,86,121,120,76,208,206,10527,1094808.0,10320,10712.0
8126,33,30,12,16,225,224,193,192,339,418,416,43425,9075825.0,43008,43472.0
8127,101,78,40,81,220,219,340,339,656,560,558,74800,20944000.0,74241,78120.0
8128,82,73,18,34,121,120,174,173,127,295,293,21054,3105465.0,20760,21608.75
8129,108,97,28,48,211,210,175,174,375,386,384,36925,7126525.0,36540,37056.0
813,56,48,13,27,139,138,273,272,240,412,410,37947,7817082.0,37536,42230.0
8132,46,41,15,23,108,107,125,124,67,233,231,13500,1572750.0,13268,13455.75
8134,56,46,23,39,157,156,151,150,114,308,306,23707,3650878.0,23400,23562.0
8135,23,20,6,9,208,207,119,118,146,327,325,24752,4046952.0,24426,26568.75
8136,49,42,17,29,154,153,177,176,174,331,329,27258,4511199.0,26928,27224.75
8137,23,20,7,9,115,114,199,198,116,314,312,22885,3592945.0,22572,24492.0
8139,50,40,20,38,242,241,88,87,121,330,328,21296,3513840.0,20967,27060.0
814,95,87,30,44,254,253,143,142,344,397,395,36322,7209917.0,35926,39203.75
8140,99,72,32,80,213,212,205,204,320,418,416,43665,9125985.0,43248,43472.0
8142,49,38,12,27,100,99,106,105,73,206,204,10600,1091800.0,10395,10506.0
8143,40,34,15,24,97,96,159,158,76,256,254,15423,1974144.0,15168,16256.0
8144,88,71,22,53,169,168,183,182,214,352,350,30927,5443152.0,30576,30800.0
8145,27,24,10,14,224,223,344,343,920,568,566,77056,21883904.0,76489,80372.0
8146,126,120,13,22,178,177,170,169,213,348,346,30260,5265240.0,29913,30102.0
8147,257,256,10,10,267,266,267,266,602,534,532,71289,19034163.0,70756,71022.0
8148,64,51,17,40,167,166,134,133,136,301,299,22378,3367889.0,22078,22499.75
8149,48,39,7,22,114,113,101,100,65,215,213,11514,1237755.0,11300,11448.75
815,56,50,23,33,173,172,165,164,177,338,336,28545,4824105.0,28208,28392.0
8150,77,69,17,30,124,123,157,156,100,281,279,19468,2735254.0,19188,19599.75
8151,55,46,21,36,152,151,241,240,192,393,391,36632,7198188.0,36240,38415.75
8152,65,58,21,33,120,119,154,153,99,274,272,18480,2531760.0,18207,18632.0
8153,58,46,19,41,166,165,130,129,195,296,294,21580,3193840.0,21285,21756.0
8156,17,16,4,4,228,227,240,239,396,468,466,54720,12804480.0,54253,54522.0
8157,46,35,13,33,178,177,90,89,80,268,266,16020,2146680.0,15753,17822.0
8158,122,116,13,23,147,146,178,177,180,325,323,26166,4251975.0,25842,26243.75
8159,53,43,16,34,260,259,149,148,327,409,407,38740,7922330.0,38332,41615.75
816,33,25,12,26,99,98,74,73,31,173,171,7326,633699.0,7154,7395.75
8160,171,157,49,75,468,467,271,270,1285,739,737,126828,46862946.0,126090,136160.75
8161,24,22,6,8,158,157,112,111,106,270,268,17696,2388960.0,17427,18090.0
8162,37,30,10,21,215,214,110,109,154,325,323,23650,3843125.0,23326,26243.75
8164,58,49,14,28,103,102,148,147,101,251,249,15244,1913122.0,14994,15624.75
8165,31,30,12,12,69,68,184,183,72,253,251,12696,1606044.0,12444,15875.75
8166,47,42,15,20,151,150,99,98,64,250,248,14949,1868625.0,14700,15500.0
8167,36,33,13,17,204,203,280,279,464,484,482,57120,13823040.0,56637,58322.0
8168,59,50,19,35,205,204,165,164,231,370,368,33825,6257625.0,33456,34040.0
817,49,33,12,41,169,168,138,137,136,307,305,23322,3579927.0,23016,23408.75
8170,94,84,25,42,224,223,142,141,235,366,364,31808,5820864.0,31443,33306.0
8171,128,104,29,71,224,223,291,290,622,515,513,65184,16784880.0,64670,66048.75
8172,97,82,28,55,244,243,192,191,287,436,434,46848,10212864.0,46413,47306.0
8173,59,38,11,49,154,153,150,149,136,304,302,23100,3511200.0,22797,22952.0
8174,54,45,11,27,91,90,162,161,83,253,251,14742,1864863.0,14490,15875.75
8175,53,50,20,24,161,160,107,106,79,268,266,17227,2308418.0,16960,17822.0
8176,80,74,21,30,150,149,233,232,280,383,381,34950,6692925.0,34568,36480.75
8177,118,93,37,84,539,538,326,325,3711,865,863,175714,75996305.0,174850,186623.75
8179,42,37,13,21,112,111,108,107,51,220,218,12096,1330560.0,11877,11990.0
818,22,19,8,10,131,130,139,138,94,270,268,18209,2458215.0,17940,18090.0
8180,120,93,40,90,537,536,383,382,2194,920,918,205671,94608660.0,204752,211140.0
8181,63,57,21,31,155,154,132,131,97,287,285,20460,2936010.0,20174,20448.75
8182,55,47,20,33,205,204,142,141,183,347,345,29110,5050585.0,28764,29928.75
8184,42,38,13,17,166,165,100,99,106,266,264,16600,2207800.0,16335,17556.0
8185,64,45,17,51,186,185,150,149,188,336,334,27900,4687200.0,27565,28056.0
8186,44,35,13,28,127,126,104,103,64,231,229,13208,1525524.0,12978,13224.75
8187,86,75,24,44,350,349,388,387,1867,738,736,135800,50110200.0,135063,135792.0
8188,61,49,20,42,151,150,218,217,262,369,367,32918,6073371.0,32550,33855.75
8189,104,87,28,58,267,266,217,216,534,484,482,57939,14021238.0,57456,58322.0
819,79,68,21,41,232,231,122,121,204,354,352,28304,5009808.0,27951,31152.0
8190,94,72,30,72,272,271,270,269,691,542,540,73440,19902240.0,72899,73170.0
8191,46,33,12,36,172,171,141,140,212,313,311,24252,3795438.0,23940,24335.75
8192,60,38,15,57,216,215,158,157,256,374,372,34128,6381936.0,33755,34782.0
8193,49,45,14,19,182,181,138,137,152,320,318,25116,4018560.0,24797,25440.0
8195,75,51,23,62,145,144,185,184,172,330,328,26825,4426125.0,26496,27060.0
8196,57,46,11,30,173,172,95,94,73,268,266,16435,2202290.0,16168,17822.0
8197,27,23,7,12,75,74,96,95,28,171,169,7200,615600.0,7030,7224.75
8198,356,342,20,46,377,376,405,404,2477,782,780,152685,59699835.0,151904,152490.0
8199,42,38,11,16,116,115,213,212,145,329,327,24708,4064466.0,24380,26895.75
82,56,47,13,29,125,124,142,141,131,267,265,17750,2369625.0,17484,17688.75
820,70,59,22,42,183,182,196,195,256,379,377,35868,6796986.0,35490,35720.75
8200,51,39,16,38,125,124,167,166,207,292,290,20875,3047750.0,20584,21170.0
8202,53,46,10,21,105,104,117,116,97,222,220,12285,1363635.0,12064,12210.0
8203,45,41,15,21,298,297,172,171,390,470,468,51256,12045160.0,50787,54990.0
8204,60,50,19,30,215,214,173,172,266,388,386,37195,7215830.0,36808,37442.0
8205,76,66,20,36,212,211,152,151,203,364,362,32224,5864768.0,31861,32942.0
8206,54,41,19,40,158,157,131,130,130,289,287,20698,2990861.0,20410,20735.75
8207,68,58,14,32,190,189,127,126,165,317,315,24130,3824605.0,23814,24963.75
8208,29,25,10,13,158,157,99,98,73,257,255,15642,2009997.0,15386,16383.75
8209,63,52,26,44,179,178,223,222,270,402,400,39917,8023317.0,39516,40200.0
821,138,137,9,9,147,146,147,146,162,294,292,21609,3176523.0,21316,21462.0
8210,120,98,29,69,298,297,252,251,797,550,548,75096,20651400.0,74547,75350.0
8211,39,36,13,17,133,132,181,180,169,314,312,24073,3779461.0,23760,24492.0
8212,67,57,15,33,119,118,142,141,79,261,259,16898,2205189.0,16638,16899.75
8213,62,49,19,43,186,185,128,127,161,314,312,23808,3737856.0,23495,24492.0
8214,36,28,12,25,217,216,293,292,575,510,508,63581,16213155.0,63072,64770.0
8215,66,52,22,47,194,193,132,131,174,326,324,25608,4174104.0,25283,26406.0
8216,72,61,21,41,292,291,168,167,340,460,458,49056,11282880.0,48597,52670.0
8217,61,54,19,31,125,124,140,139,87,265,263,17500,2318750.0,17236,17423.75
8218,82,73,21,37,158,157,233,232,224,391,389,36814,7197137.0,36424,38024.75
8219,92,80,27,49,192,191,159,158,184,351,349,30528,5357664.0,30178,30624.75
822,59,47,16,38,181,180,180,179,233,361,359,32580,5880690.0,32220,32399.75
8220,50,43,18,29,154,153,142,141,111,296,294,21868,3236464.0,21573,21756.0
8221,60,45,14,34,168,167,129,128,146,297,295,21672,3218292.0,21376,21903.75
8222,48,42,10,19,119,118,121,120,75,240,238,14399,1727880.0,14160,14280.0
8223,53,43,9,21,113,112,147,146,121,260,258,16611,2159430.0,16352,16770.0
8224,71,60,27,47,344,343,363,362,1880,707,705,124872,44142252.0,124166,124608.75
8225,47,37,13,27,137,136,176,175,130,313,311,24112,3773528.0,23800,24335.75
8226,82,72,16,30,129,128,138,137,89,267,265,17802,2376567.0,17536,17688.75
8227,27,24,9,12,191,190,146,145,171,337,335,27886,4698791.0,27550,28223.75
8228,82,61,24,61,200,199,147,146,236,347,345,29400,5100900.0,29054,29928.75
8229,36,29,13,23,181,180,103,102,127,284,282,18643,2647306.0,18360,20022.0
823,59,49,16,32,181,180,164,163,231,345,343,29684,5120490.0,29340,29583.75
8230,136,110,40,90,358,357,322,321,1122,680,678,115276,39193840.0,114597,115260.0
8231,58,53,16,24,105,104,143,142,72,248,246,15015,1861860.0,14768,15252.0
8232,79,65,24,48,446,445,250,249,1480,696,694,111500,38802000.0,110805,120756.0
8233,53,47,18,28,130,129,174,173,153,304,302,22620,3438240.0,22317,22952.0
8234,45,31,9,34,113,112,129,128,71,242,240,14577,1763817.0,14336,14520.0
8235,40,34,7,16,148,147,143,142,133,291,289,21164,3079362.0,20874,21024.75
8236,114,96,32,66,210,209,354,353,587,564,562,74340,20963880.0,73777,79242.0
8237,93,80,25,49,376,375,397,396,2074,773,771,149272,57693628.0,148500,148995.75
8238,43,31,12,31,151,150,100,99,70,251,249,15100,1895050.0,14850,15624.75
8239,37,29,11,23,96,95,91,90,45,187,185,8736,816816.0,8550,8648.75
824,87,76,21,40,195,194,185,184,231,380,378,36075,6854250.0,35696,35910.0
8240,60,52,24,38,151,150,128,127,91,279,277,19328,2696256.0,19050,19320.75
8241,52,36,15,45,167,166,101,100,79,268,266,16867,2260178.0,16600,17822.0
8242,32,29,9,13,149,148,105,104,92,254,252,15645,1986915.0,15392,16002.0
8243,29,25,10,16,141,140,227,226,171,368,366,32007,5889288.0,31640,33672.0
8244,50,37,14,35,224,223,152,151,312,376,374,34048,6401024.0,33673,35156.0
8245,39,32,11,22,205,204,146,145,163,351,349,29930,5252715.0,29580,30624.75
8246,241,221,34,72,323,322,367,366,1619,690,688,118541,40896645.0,117852,118680.0
8247,37,33,12,16,120,119,107,106,91,227,225,12840,1457340.0,12614,12768.75
8248,25,23,5,7,125,124,123,122,69,248,246,15375,1906500.0,15128,15252.0
8249,28,23,6,14,137,136,184,183,201,321,319,25208,4045884.0,24888,25599.75
825,64,45,13,47,168,167,160,159,204,328,326,26880,4408320.0,26553,26732.0
8250,58,50,14,28,135,134,140,139,100,275,273,18900,2598750.0,18626,18768.75
8251,65,50,18,46,149,148,182,181,235,331,329,27118,4488029.0,26788,27224.75
8252,119,118,6,6,193,192,170,169,235,363,361,32810,5955015.0,32448,32760.75
8253,234,204,46,104,373,372,514,513,3936,887,885,191722,85028707.0,190836,196248.75
8254,75,60,23,50,169,168,146,145,156,315,313,24674,3886155.0,24360,24648.75
8256,69,58,19,39,126,125,162,161,130,288,286,20412,2939328.0,20125,20592.0
8257,71,63,24,38,141,140,172,171,124,313,311,24252,3795438.0,23940,24335.75
8258,97,91,21,31,139,138,161,160,134,300,298,22379,3356850.0,22080,22350.0
8259,50,46,16,22,130,129,144,143,136,274,272,18720,2564640.0,18447,18632.0
826,27,24,7,11,177,176,177,176,244,354,352,31329,5545233.0,30976,31152.0
8260,59,48,15,30,135,134,149,148,163,284,282,20115,2856330.0,19832,20022.0
8261,94,83,21,41,140,139,206,205,191,346,344,28840,4989320.0,28495,29756.0
8262,36,31,18,26,79,78,270,269,181,349,347,21330,3722085.0,20982,30275.75
8263,30,26,9,15,266,265,154,153,318,420,418,40964,8602440.0,40545,43890.0
8264,45,39,16,25,232,231,192,191,407,424,422,44544,9443328.0,44121,44732.0
8265,69,60,16,31,138,137,148,147,105,286,284,20424,2920632.0,20139,20306.0
8266,46,36,10,27,91,90,199,198,124,290,288,18109,2625805.0,17820,20880.0
8267,102,91,21,41,229,228,147,146,232,376,374,33663,6328644.0,33288,35156.0
8268,75,67,29,41,229,228,159,158,248,388,386,36411,7063734.0,36024,37442.0
8269,76,64,27,48,287,286,251,250,587,538,536,72037,19377953.0,71500,72092.0
827,97,79,31,64,505,504,285,284,2442,790,788,143925,56850375.0,143136,155630.0
8270,78,62,20,50,298,297,229,228,737,527,525,68242,17981767.0,67716,69168.75
8271,47,42,16,22,145,144,123,122,89,268,266,17835,2389890.0,17568,17822.0
8272,52,44,18,30,223,222,137,136,302,360,358,30551,5499180.0,30192,32220.0
8273,31,24,14,24,153,152,396,395,589,549,547,60588,16631406.0,60040,75075.75
8274,92,76,30,55,267,266,254,253,645,521,519,67818,17666589.0,67298,67599.75
8275,35,26,9,24,88,87,128,127,58,216,214,11264,1216512.0,11049,11556.0
8276,63,45,27,59,188,187,349,348,879,537,535,65612,17616822.0,65076,71823.75
8277,47,38,15,30,102,101,161,160,96,263,261,16422,2159493.0,16160,17160.75
8278,36,31,7,13,105,104,213,212,123,318,316,22365,3556035.0,22048,25122.0
8279,75,57,24,58,273,272,187,186,406,460,458,51051,11741730.0,50592,52670.0
828,29,24,11,17,114,113,217,216,185,331,329,24738,4094139.0,24408,27224.75
8280,49,35,16,37,192,191,206,205,374,398,396,39552,7870848.0,39155,39402.0
8281,120,114,11,21,178,177,147,146,217,325,323,26166,4251975.0,25842,26243.75
8282,116,95,43,83,262,261,239,238,444,501,499,62618,15685809.0,62118,62499.75
8283,41,35,10,15,88,87,222,221,118,310,308,19536,3028080.0,19227,23870.0
8284,44,38,14,23,103,102,132,131,121,235,233,13596,1597530.0,13362,13688.75
8285,73,57,23,53,242,241,148,147,296,390,388,35816,6984120.0,35427,37830.0
8286,83,69,23,47,262,261,169,168,332,431,429,44278,9541909.0,43848,46224.75
8287,61,54,20,32,220,219,122,121,276,342,340,26840,4589640.0,26499,29070.0
8288,79,72,19,31,131,130,139,138,121,270,268,18209,2458215.0,17940,18090.0
8289,66,60,17,27,141,140,267,266,355,408,406,37647,7679988.0,37240,41412.0
829,74,64,18,36,116,115,211,210,135,327,325,24476,4001826.0,24150,26568.75
8290,22,20,7,9,161,160,222,221,187,383,381,35742,6844593.0,35360,36480.75
8291,101,93,17,30,198,197,142,141,236,340,338,28116,4779720.0,27777,28730.0
8292,49,37,19,41,146,145,175,174,223,321,319,25550,4100775.0,25230,25599.75
8294,54,42,19,40,255,254,95,94,139,350,348,24225,4239375.0,23876,30450.0
8295,43,31,14,32,100,99,137,136,84,237,235,13700,1623450.0,13464,13923.75
8296,27,20,6,16,111,110,76,75,45,187,185,8436,788766.0,8250,8648.75
8297,84,67,21,53,192,191,209,208,324,401,399,40128,8045664.0,39728,39999.75
8298,81,60,20,55,164,163,200,199,250,364,362,32800,5969600.0,32437,32942.0
8299,21,19,8,10,174,173,200,199,221,374,372,34800,6507600.0,34427,34782.0
83,75,43,18,80,346,345,359,358,1414,705,703,124214,43785435.0,123510,123903.75
830,43,33,17,35,110,109,85,84,42,195,193,9350,911625.0,9156,9408.75
8300,40,34,10,16,151,150,103,102,92,254,252,15553,1975231.0,15300,16002.0
8301,52,43,13,29,145,144,88,87,66,233,231,12760,1486540.0,12528,13455.75
8302,73,61,24,44,184,183,201,200,254,385,383,36984,7119420.0,36600,36863.75
8303,55,45,14,30,122,121,114,113,65,236,234,13908,1641144.0,13673,13806.0
8304,62,57,17,25,169,168,136,135,114,305,303,22984,3505060.0,22680,23103.75
8305,51,36,14,42,158,157,181,180,235,339,337,28598,4847361.0,28260,28560.75
8306,65,57,18,30,144,143,185,184,170,329,327,26640,4382280.0,26312,26895.75
8308,43,36,9,20,91,90,119,118,50,210,208,10829,1137045.0,10620,10920.0
8309,75,67,22,36,168,167,232,231,247,400,398,38976,7795200.0,38577,39800.0
831,26,23,9,12,256,255,244,243,480,500,498,62464,15616000.0,61965,62250.0
8310,48,43,17,25,96,95,133,132,74,229,227,12768,1461936.0,12540,12995.75
8311,59,50,15,31,290,289,184,183,404,474,472,53360,12646320.0,52887,55932.0
8313,64,59,12,20,181,180,100,99,82,281,279,18100,2543050.0,17820,19599.75
8314,62,58,19,25,188,187,95,94,159,283,281,17860,2527190.0,17578,19880.75
8315,50,44,16,26,137,136,237,236,250,374,372,32469,6071703.0,32096,34782.0
8316,45,39,10,19,98,97,122,121,55,220,218,11956,1315160.0,11737,11990.0
8317,35,31,11,15,122,121,123,122,78,245,243,15006,1838235.0,14762,14883.75
8318,70,56,17,43,203,202,148,147,247,351,349,30044,5272722.0,29694,30624.75
8319,53,51,11,13,128,127,153,152,183,281,279,19584,2751552.0,19304,19599.75
8320,46,41,13,19,104,103,98,97,50,202,200,10192,1029392.0,9991,10100.0
8321,102,84,37,70,266,265,198,197,541,464,462,52668,12218976.0,52205,53592.0
8322,64,51,23,44,234,233,198,197,297,432,430,46332,10007712.0,45901,46440.0
8323,74,59,16,41,108,107,148,147,80,256,254,15984,2045952.0,15729,16256.0
8324,65,48,20,52,224,223,199,198,343,423,421,44576,9427824.0,44154,44520.75
8325,62,49,23,47,145,144,138,137,112,283,281,20010,2831415.0,19728,19880.75
8326,106,79,34,84,507,506,386,385,2581,893,891,195702,87380943.0,194810,198915.75
8327,72,57,21,45,175,174,259,258,322,434,432,45325,9835525.0,44892,46872.0
8328,35,29,12,21,202,201,183,182,256,385,383,36966,7115955.0,36582,36863.75
8329,54,42,17,39,121,120,165,164,142,286,284,19965,2854995.0,19680,20306.0
833,96,82,22,47,170,169,222,221,397,392,390,37740,7397040.0,37349,38220.0
8330,48,40,13,27,171,170,104,103,125,275,273,17784,2445300.0,17510,18768.75
8331,64,55,21,37,303,302,348,347,648,651,649,105444,34322022.0,104794,105624.75
8332,78,56,24,66,307,306,240,239,727,547,545,73680,20151480.0,73134,74528.75
8333,53,41,17,38,146,145,118,117,65,264,262,17228,2274096.0,16965,17292.0
8334,107,87,38,75,305,304,327,326,897,632,630,99735,31516260.0,99104,99540.0
8335,59,43,18,47,387,386,136,135,447,523,521,52632,13763268.0,52110,68120.75
8336,50,43,16,27,209,208,143,142,186,352,350,29887,5260112.0,29536,30800.0
8337,89,63,25,69,195,194,300,299,560,495,493,58500,14478750.0,58006,61008.75
8338,76,67,22,38,168,167,242,241,359,410,408,40656,8334480.0,40247,41820.0
8339,51,39,16,36,92,91,128,127,63,220,218,11776,1295360.0,11557,11990.0
834,32,27,11,17,158,157,160,159,138,318,316,25280,4019520.0,24963,25122.0
8340,49,48,10,10,180,179,208,207,275,388,386,37440,7263360.0,37053,37442.0
8341,105,77,31,84,231,230,271,270,1080,502,500,62601,15712851.0,62100,62750.0
8342,102,80,40,81,349,348,319,318,985,668,666,111331,37184554.0,110664,111222.0
8343,81,70,22,42,200,199,126,125,141,326,324,25200,4107600.0,24875,26406.0
8344,45,39,17,27,107,106,124,123,76,231,229,13268,1532454.0,13038,13224.75
8345,24,19,7,11,497,496,509,508,5358,1006,1004,252973,127245419.0,251968,252506.0
8346,119,118,6,6,216,215,239,238,476,455,453,51624,11744460.0,51170,51528.75
8347,63,53,19,34,134,133,177,176,150,311,309,23718,3688149.0,23408,24024.75
8348,111,104,26,38,198,197,145,144,209,343,341,28710,4923765.0,28368,29240.75
835,57,45,17,39,175,174,127,126,129,302,300,22225,3355975.0,21924,22650.0
8350,84,69,31,58,184,183,183,182,259,367,365,33672,6178812.0,33306,33488.75
8352,63,53,19,36,172,171,166,165,178,338,336,28552,4825288.0,28215,28392.0
8353,60,44,15,44,158,157,186,185,220,344,342,29388,5054736.0,29045,29412.0
8354,100,83,33,63,242,241,207,206,415,449,447,50094,11246103.0,49646,50175.75
8355,58,45,17,40,146,145,145,144,118,291,289,21170,3080235.0,20880,21024.75
8356,54,45,16,32,108,107,85,84,50,193,191,9180,885870.0,8988,9215.75
8357,48,37,14,29,122,121,187,186,145,309,307,22814,3524763.0,22506,23715.75
8358,63,61,13,15,135,134,115,114,100,250,248,15525,1940625.0,15276,15500.0
8359,52,47,15,23,109,108,88,87,36,197,195,9592,944812.0,9396,9603.75
836,77,60,23,54,130,129,174,173,152,304,302,22620,3438240.0,22317,22952.0
8360,90,72,38,68,366,365,335,334,1100,701,699,122610,42974805.0,121910,122499.75
8361,144,101,43,126,317,316,287,286,1142,604,602,90979,27475658.0,90376,90902.0
8362,80,67,23,44,129,128,181,180,171,310,308,23349,3619095.0,23040,23870.0
8363,60,53,17,28,144,143,90,89,87,234,232,12960,1516320.0,12727,13572.0
8364,117,92,35,83,184,183,296,295,479,480,478,54464,13071360.0,53985,57360.0
8365,65,50,26,53,152,151,193,192,223,345,343,29336,5060460.0,28992,29583.75
8366,58,47,12,31,159,158,139,138,117,298,296,22101,3293049.0,21804,22052.0
8367,28,23,8,14,289,288,189,188,554,478,476,54621,13054419.0,54144,56882.0
8368,69,50,20,56,255,254,382,381,1375,637,635,97410,31025085.0,96774,101123.75
8369,61,52,19,32,211,210,110,109,133,321,319,23210,3725205.0,22890,25599.75
837,61,54,17,28,191,190,195,194,315,386,384,37245,7188285.0,36860,37056.0
8370,49,38,15,34,228,227,125,124,178,353,351,28500,5030250.0,28148,30975.75
8371,79,66,22,46,150,149,149,148,143,299,297,22350,3341325.0,22052,22200.75
8373,42,30,13,35,211,210,189,188,268,400,398,39879,7975800.0,39480,39800.0
8374,131,113,40,73,282,281,256,255,780,538,536,72192,19419648.0,71655,72092.0
8375,72,57,21,49,131,130,150,149,126,281,279,19650,2760825.0,19370,19599.75
8377,40,36,11,15,152,151,295,294,328,447,445,44840,10021740.0,44394,49728.75
8378,202,167,68,135,457,456,514,513,5992,971,969,234898,114042979.0,233928,235224.75
8379,25,23,6,7,156,155,209,208,170,365,363,32604,5950230.0,32240,33123.75
838,56,49,12,24,104,103,127,126,59,231,229,13208,1525524.0,12978,13224.75
8380,104,88,24,54,157,156,209,208,175,366,364,32813,6004779.0,32448,33306.0
8381,31,27,9,15,94,93,88,87,31,182,180,8272,752752.0,8091,8190.0
8382,111,93,33,65,267,266,192,191,288,459,457,51264,11765088.0,50806,52440.75
8383,361,353,15,29,377,376,377,376,2036,754,752,142129,53582633.0,141376,141752.0
8384,30,25,9,15,113,112,125,124,67,238,236,14125,1680875.0,13888,14042.0
8385,101,83,31,64,328,327,447,446,1237,775,773,146616,56813700.0,145842,149768.75
8386,102,85,38,69,330,329,247,246,870,577,575,81510,23515635.0,80934,82943.75
8387,47,38,16,30,112,111,170,169,119,282,280,19040,2684640.0,18759,19740.0
8388,43,41,10,12,220,219,141,140,275,361,359,31020,5599110.0,30660,32399.75
8389,47,38,14,29,118,117,129,128,87,247,245,15222,1879917.0,14976,15128.75
839,53,38,12,37,142,141,195,194,263,337,335,27690,4665765.0,27354,28223.75
8390,44,37,15,27,182,181,93,92,138,275,273,16926,2327325.0,16652,18768.75
8391,35,26,9,23,173,172,149,148,202,322,320,25777,4150097.0,25456,25760.0
8392,158,155,10,14,170,169,262,261,395,432,430,44540,9620640.0,44109,46440.0
8393,42,38,9,13,234,233,190,189,333,424,422,44460,9425520.0,44037,44732.0
8394,74,63,25,43,178,177,163,162,213,341,339,29014,4946887.0,28674,28899.75
8395,40,30,12,24,124,123,152,151,109,276,274,18848,2601024.0,18573,18906.0
8396,42,32,9,26,112,111,83,82,103,195,193,9296,906360.0,9102,9408.75
8397,70,61,20,36,294,293,196,195,378,490,488,57624,14117880.0,57135,59780.0
8398,55,44,13,30,200,199,166,165,253,366,364,33200,6075600.0,32835,33306.0
8399,70,57,24,48,156,155,140,139,143,296,294,21840,3232320.0,21545,21756.0
84,53,47,15,25,142,141,118,117,97,260,258,16756,2178280.0,16497,16770.0
8400,109,87,35,75,270,269,189,188,426,459,457,51030,11711385.0,50572,52440.75
8401,76,63,15,38,191,190,130,129,165,321,319,24830,3985215.0,24510,25599.75
8402,51,42,18,34,315,314,218,217,682,533,531,68670,18300555.0,68138,70755.75
8403,31,28,8,12,140,139,283,282,296,423,421,39620,8379630.0,39198,44520.75
8404,41,34,10,17,95,94,102,101,49,197,195,9690,954465.0,9494,9603.75
8405,32,29,8,12,98,97,131,130,64,229,227,12838,1469951.0,12610,12995.75
8406,43,33,14,31,150,149,126,125,126,276,274,18900,2608200.0,18625,18906.0
8407,47,40,12,20,160,159,211,210,199,371,369,33760,6262480.0,33390,34224.75
8408,29,26,10,12,105,104,83,82,48,188,186,8715,819210.0,8528,8742.0
8409,91,68,29,73,264,263,238,237,548,502,500,62832,15770832.0,62331,62750.0
841,54,50,16,22,196,195,99,98,117,295,293,19404,2862090.0,19110,21608.75
8410,69,49,21,57,215,214,382,381,632,597,595,82130,24515805.0,81534,88803.75
8411,52,44,13,27,85,84,92,91,32,177,175,7820,692070.0,7644,7743.75
8412,121,92,46,102,359,358,362,361,1158,721,719,129958,46849859.0,129238,129599.75
8413,30,29,8,8,141,140,162,161,119,303,301,22842,3460563.0,22540,22800.75
8414,37,30,7,13,94,93,152,151,102,246,244,14288,1757424.0,14043,15006.0
8415,96,82,26,51,238,237,207,206,384,445,443,49266,10961685.0,48822,49283.75
8416,61,56,17,25,127,126,197,196,150,324,322,25019,4053078.0,24696,26082.0
8417,77,67,30,47,357,356,277,276,750,634,632,98889,31347813.0,98256,100172.0
8418,39,30,4,19,226,225,181,180,442,407,405,40906,8324371.0,40500,41208.75
8419,43,35,12,26,171,170,112,111,157,283,281,19152,2710008.0,18870,19880.75
842,26,23,6,9,157,156,105,104,81,262,260,16485,2159535.0,16224,17030.0
8420,44,35,12,24,136,135,208,207,258,344,342,28288,4865536.0,27945,29412.0
8422,61,53,21,35,147,146,140,139,138,287,285,20580,2953230.0,20294,20448.75
8423,21,20,6,6,64,63,82,81,22,146,144,5248,383104.0,5103,5256.0
8424,354,340,19,45,405,404,377,376,2399,782,780,152685,59699835.0,151904,152490.0
8425,32,25,11,23,149,148,123,122,121,272,270,18327,2492472.0,18056,18360.0
8426,27,25,10,12,98,97,229,228,162,327,325,22442,3669267.0,22116,26568.75
8427,31,30,10,10,121,120,126,125,87,247,245,15246,1882881.0,15000,15128.75
8428,256,252,21,27,406,405,340,339,1893,746,744,138040,51488920.0,137295,138756.0
8429,53,48,13,21,111,110,168,167,102,279,277,18648,2601396.0,18370,19320.75
843,59,55,21,27,156,155,134,133,112,290,288,20904,3031080.0,20615,20880.0
8430,89,82,22,33,204,203,279,278,371,483,481,56916,13745214.0,56434,58080.75
8431,28,27,7,7,493,492,164,163,518,657,655,80852,26559882.0,80196,107583.75
8432,44,37,15,27,127,126,166,165,143,293,291,21082,3088513.0,20790,21315.75
8433,84,74,23,41,150,149,154,153,112,304,302,23100,3511200.0,22797,22952.0
8434,102,79,31,73,304,303,251,250,890,555,553,76304,21174360.0,75750,76728.75
8435,40,34,11,17,113,112,122,121,69,235,233,13786,1619855.0,13552,13688.75
8436,100,82,31,65,255,254,496,495,1595,751,749,126480,47493240.0,125730,140624.75
8437,61,44,19,51,267,266,143,142,300,410,408,38181,7827105.0,37772,41820.0
8438,102,89,28,52,340,339,172,171,696,512,510,58480,14970880.0,57969,65280.0
8439,47,43,12,17,106,105,79,78,40,185,183,8374,774595.0,8190,8463.75
844,57,49,21,35,181,180,249,248,305,430,428,45069,9689835.0,44640,46010.0
8440,120,105,33,61,473,472,348,347,6129,821,819,164604,67569942.0,163784,168099.75
8441,83,73,22,40,170,169,177,176,187,347,345,30090,5220615.0,29744,29928.75
8442,34,31,11,14,135,134,151,150,94,286,284,20385,2915055.0,20100,20306.0
8443,32,25,12,24,124,123,121,120,85,245,243,15004,1837990.0,14760,14883.75
8444,27,21,7,16,208,207,207,206,248,415,413,43056,8934120.0,42642,42848.75
8445,41,38,6,10,82,81,164,163,65,246,244,13448,1654104.0,13203,15006.0
8446,166,141,55,102,408,407,376,375,1738,784,782,153408,60135936.0,152625,153272.0
8447,37,30,12,21,165,164,88,87,61,253,251,14520,1836780.0,14268,15875.75
8448,83,72,26,46,159,158,151,150,127,310,308,24009,3721395.0,23700,23870.0
8449,57,52,19,26,125,124,111,110,68,236,234,13875,1637250.0,13640,13806.0
845,56,49,22,34,257,256,183,182,275,440,438,47031,10346820.0,46592,48180.0
8450,62,50,23,45,196,195,460,459,851,656,654,90160,29572480.0,89505,107256.0
8451,151,132,43,79,391,390,257,256,1016,648,646,100487,32557788.0,99840,104652.0
8452,123,103,36,72,270,269,331,330,650,601,599,89370,26855685.0,88770,89999.75
8453,56,46,13,31,125,124,88,87,50,213,211,11000,1171500.0,10788,11235.75
8454,29,25,7,13,175,174,120,119,105,295,293,21000,3097500.0,20706,21608.75
8455,54,35,16,50,246,245,112,111,239,358,356,27552,4931808.0,27195,31862.0
8456,39,29,12,30,155,154,114,113,122,269,267,17670,2376615.0,17402,17955.75
8457,55,44,16,36,245,244,216,215,539,461,459,52920,12198060.0,52460,52899.75
8458,48,42,13,23,108,107,170,169,134,278,276,18360,2552040.0,18083,19182.0
8459,29,24,10,18,311,310,190,189,458,501,499,59090,14802045.0,58590,62499.75
846,35,32,9,13,522,521,150,149,846,672,670,78300,26308800.0,77629,112560.0
8460,17,15,5,7,138,137,76,75,63,214,212,10488,1122216.0,10275,11342.0
8461,22,19,7,10,130,129,238,237,199,368,366,30940,5692960.0,30573,33672.0
8462,37,32,11,17,90,89,224,223,110,314,312,20160,3165120.0,19847,24492.0
8463,66,57,20,34,147,146,147,146,130,294,292,21609,3176523.0,21316,21462.0
8464,73,61,21,43,193,192,210,209,234,403,401,40530,8166795.0,40128,40400.75
8465,54,45,16,30,164,163,135,134,125,299,297,22140,3309930.0,21842,22200.75
8466,49,40,18,34,111,110,164,163,72,275,273,18204,2503050.0,17930,18768.75
8467,133,107,35,81,284,283,386,385,1239,670,668,109624,36724040.0,108955,111890.0
8468,28,25,9,13,94,93,100,99,33,194,192,9400,911800.0,9207,9312.0
8469,51,39,17,39,202,201,192,191,219,394,392,38784,7640448.0,38391,38612.0
847,32,24,8,19,181,180,153,152,183,334,332,27693,4624731.0,27360,27722.0
8470,67,57,21,39,156,155,156,155,157,312,310,24336,3796416.0,24025,24180.0
8471,103,87,32,61,398,397,468,467,3054,866,864,186264,80652312.0,185399,187056.0
8472,81,60,21,59,200,199,267,266,544,467,465,53400,12468900.0,52934,54288.75
8473,38,33,14,22,119,118,111,110,69,230,228,13209,1519035.0,12980,13110.0
8475,78,65,18,41,139,138,198,197,165,337,335,27522,4637457.0,27186,28223.75
8476,46,38,12,25,159,158,140,139,167,299,297,22260,3327870.0,21962,22200.75
8477,86,78,22,36,181,180,235,234,324,416,414,42535,8847280.0,42120,43056.0
8478,83,73,25,43,257,256,144,143,249,401,399,37008,7420104.0,36608,39999.75
8479,30,27,9,13,103,102,167,166,79,270,268,17201,2322135.0,16932,18090.0
848,47,41,18,27,113,112,220,219,150,333,331,24860,4139190.0,24528,27555.75
8480,48,39,19,34,209,208,129,128,134,338,336,26961,4556409.0,26624,28392.0
8481,91,82,20,33,204,203,188,187,193,392,390,38352,7516992.0,37961,38220.0
8482,77,60,25,56,128,127,165,164,142,293,291,21120,3094080.0,20828,21315.75
8483,49,44,17,23,158,157,146,145,170,304,302,23068,3506336.0,22765,22952.0
8484,74,61,24,48,174,173,219,218,241,393,391,38106,7487829.0,37714,38415.75
8485,32,30,10,11,227,226,220,219,354,447,445,49940,11161590.0,49494,49728.75
8486,27,19,7,17,78,77,102,101,38,180,178,7956,716040.0,7777,8010.0
8487,37,32,11,16,124,123,108,107,72,232,230,13392,1553472.0,13161,13340.0
8488,74,64,27,45,200,199,191,190,337,391,389,38200,7468100.0,37810,38024.75
8489,121,100,37,77,253,252,291,290,693,544,542,73623,20025456.0,73080,73712.0
849,42,37,12,20,178,177,168,167,233,346,344,29904,5173392.0,29559,29756.0
8490,88,73,23,51,188,187,170,169,200,358,356,31960,5720840.0,31603,31862.0
8491,47,38,17,31,120,119,138,137,92,258,256,16560,2136240.0,16303,16512.0
8492,56,49,23,34,185,184,132,131,125,317,315,24420,3870570.0,24104,24963.75
8493,62,50,22,43,269,268,243,242,618,512,510,65367,16733952.0,64856,65280.0
8494,76,68,16,27,209,208,155,154,232,364,362,32395,5895890.0,32032,32942.0
8495,36,31,12,18,183,182,88,87,78,271,269,16104,2182092.0,15834,18224.75
8496,171,150,36,76,267,266,291,290,836,558,556,77697,21677463.0,77140,77562.0
8497,69,60,23,38,267,266,255,254,527,522,520,68085,17770185.0,67564,67860.0
8498,54,37,19,51,214,213,126,125,150,340,338,26964,4583880.0,26625,28730.0
8499,64,50,22,47,148,147,230,229,192,378,376,34040,6433560.0,33663,35532.0
85,30,24,8,16,137,136,161,160,142,298,296,22057,3286493.0,21760,22052.0
850,34,20,9,35,194,193,195,194,299,389,387,37830,7357935.0,37442,37635.75
8500,41,35,11,20,174,173,184,183,333,358,356,32016,5730864.0,31659,31862.0
8501,252,251,10,10,267,266,267,266,594,534,532,71289,19034163.0,70756,71022.0
8502,53,46,12,20,90,89,127,126,71,217,215,11430,1240155.0,11214,11663.75
8503,65,57,21,35,115,114,187,186,191,302,300,21505,3247255.0,21204,22650.0
8504,94,81,38,59,215,214,238,237,592,453,451,51170,11590005.0,50718,51075.75
8506,76,62,26,52,214,213,131,130,281,345,343,28034,4835865.0,27690,29583.75
8507,53,38,14,33,132,131,222,221,197,354,352,29304,5186808.0,28951,31152.0
8508,68,54,19,44,120,119,153,152,128,273,271,18360,2506140.0,18088,18495.75
8509,89,80,26,41,273,272,257,256,491,530,528,70161,18592665.0,69632,69960.0
851,113,101,33,55,311,310,313,312,1135,624,622,97343,30371016.0,96720,97032.0
8510,70,58,26,47,205,204,173,172,302,378,376,35465,6702885.0,35088,35532.0
8511,47,40,16,28,111,110,188,187,118,299,297,20868,3119766.0,20570,22200.75
8512,94,74,25,63,187,186,355,354,727,542,540,66385,17990335.0,65844,73170.0
8513,140,117,40,84,378,377,250,249,811,628,626,94500,29673000.0,93873,98282.0
8514,151,116,40,104,305,304,259,258,657,564,562,78995,22276590.0,78432,79242.0
8515,65,54,17,37,202,201,105,104,141,307,305,21210,3255735.0,20904,23408.75
8516,68,48,18,56,139,138,124,123,112,263,261,17236,2266534.0,16974,17160.75
8517,104,96,34,47,186,185,260,259,363,446,444,48360,10784280.0,47915,49506.0
8518,171,170,7,7,178,177,178,177,168,356,354,31684,5639752.0,31329,31506.0
8519,43,34,13,29,149,148,153,152,102,302,300,22797,3442347.0,22496,22650.0
852,41,32,12,26,221,220,109,108,159,330,328,24089,3974685.0,23760,27060.0
8520,75,57,25,56,267,266,243,242,607,510,508,64881,16544655.0,64372,64770.0
8521,61,48,16,40,162,161,385,384,695,547,545,62370,17058195.0,61824,74528.75
8522,46,40,14,24,113,112,128,127,87,241,239,14464,1742912.0,14224,14399.75
8523,120,101,28,62,437,436,335,334,2052,772,770,146395,56508470.0,145624,148610.0
8524,78,65,20,43,242,241,258,257,598,500,498,62436,15609000.0,61937,62250.0
8525,59,45,14,39,135,134,171,170,114,306,304,23085,3532005.0,22780,23256.0
8526,37,32,12,18,135,134,167,166,136,302,300,22545,3404295.0,22244,22650.0
8527,70,55,18,46,199,198,213,212,342,412,410,42387,8731722.0,41976,42230.0
8528,31,27,6,11,163,162,123,122,113,286,284,20049,2867007.0,19764,20306.0
8529,82,69,27,49,276,275,284,283,1004,560,558,78384,21947520.0,77825,78120.0
853,29,20,8,21,120,119,90,89,50,210,208,10800,1134000.0,10591,10920.0
8530,64,47,16,37,179,178,151,150,204,330,328,27029,4459785.0,26700,27060.0
8531,43,29,14,38,193,192,113,112,107,306,304,21809,3336777.0,21504,23256.0
8532,34,29,14,21,123,122,154,153,111,277,275,18942,2623467.0,18666,19043.75
8533,53,45,20,32,157,156,211,210,230,368,366,33127,6095368.0,32760,33672.0
8534,61,56,10,18,101,100,91,90,36,192,190,9191,882336.0,9000,9120.0
8535,251,225,36,86,318,317,380,379,1662,698,696,120840,42173160.0,120143,121452.0
8536,53,46,11,18,90,89,144,143,52,234,232,12960,1516320.0,12727,13572.0
8537,77,69,15,29,164,163,181,180,234,345,343,29684,5120490.0,29340,29583.75
8538,56,42,14,40,105,104,129,128,73,234,232,13545,1584765.0,13312,13572.0
8539,103,80,25,65,450,449,236,235,1301,686,684,106200,36426600.0,105515,117306.0
854,38,33,11,18,143,142,97,96,67,240,238,13871,1664520.0,13632,14280.0
8541,53,47,14,24,149,148,153,152,130,302,300,22797,3442347.0,22496,22650.0
8542,219,217,9,11,227,226,367,366,910,594,592,83309,24742773.0,82716,87912.0
8543,86,77,24,40,200,199,236,235,299,436,434,47200,10289600.0,46765,47306.0
8544,68,61,15,26,157,156,163,162,154,320,318,25591,4094560.0,25272,25440.0
8545,71,59,21,42,164,163,190,189,175,354,352,31160,5515320.0,30807,31152.0
8546,65,45,18,49,248,247,170,169,329,418,416,42160,8811440.0,41743,43472.0
8547,33,30,11,13,130,129,315,314,328,445,443,40950,9111375.0,40506,49283.75
8548,70,58,15,37,129,128,170,169,165,299,297,21930,3278535.0,21632,22200.75
8549,40,35,12,20,136,135,186,185,161,322,320,25296,4072656.0,24975,25760.0
855,50,38,15,37,217,216,181,180,299,398,396,39277,7816123.0,38880,39402.0
8550,74,56,23,56,151,150,163,162,160,314,312,24613,3864241.0,24300,24492.0
8551,52,41,19,39,128,127,231,230,203,359,357,29568,5307456.0,29210,32040.75
8552,65,51,21,47,166,165,187,186,221,353,351,31042,5478913.0,30690,30975.75
8553,41,34,14,22,73,72,121,120,41,194,192,8833,856801.0,8640,9312.0
8554,42,36,16,26,169,168,148,147,160,317,315,25012,3964402.0,24696,24963.75
8555,85,73,34,56,247,246,200,199,511,447,445,49400,11040900.0,48954,49728.75
8556,50,37,18,40,119,118,257,256,257,376,374,30583,5749604.0,30208,35156.0
8557,42,29,14,38,87,86,213,212,123,300,298,18531,2779650.0,18232,22350.0
8558,70,65,22,27,165,164,136,135,128,301,299,22440,3377220.0,22140,22499.75
8559,28,26,10,12,156,155,196,195,216,352,350,30576,5381376.0,30225,30800.0
856,80,68,27,49,244,243,368,367,1010,612,610,89792,27476352.0,89181,93330.0
8560,64,52,20,42,130,129,193,192,191,323,321,25090,4052035.0,24768,25920.75
8561,38,28,10,20,121,120,181,180,148,302,300,21901,3307051.0,21600,22650.0
8562,75,52,24,68,247,246,159,158,362,406,404,39273,7972419.0,38868,41006.0
8563,65,56,20,36,188,187,131,130,120,319,317,24628,3928166.0,24310,25280.75
8564,81,65,24,54,141,140,142,141,157,283,281,20022,2833113.0,19740,19880.75
8565,53,46,11,22,92,91,111,110,40,203,201,10212,1036518.0,10010,10200.75
8566,72,63,20,33,155,154,205,204,236,360,358,31775,5719500.0,31416,32220.0
8567,28,25,12,16,158,157,159,158,134,317,315,25122,3981837.0,24806,24963.75
8568,91,79,28,49,330,329,237,236,727,567,565,78210,22172535.0,77644,80088.75
8569,67,56,22,40,146,145,176,175,232,322,320,25696,4137056.0,25375,25760.0
857,48,38,11,26,127,126,140,139,252,267,265,17780,2373630.0,17514,17688.75
8570,49,40,14,29,105,104,116,115,72,221,219,12180,1345890.0,11960,12099.75
8571,44,36,14,26,114,113,166,165,96,280,278,18924,2649360.0,18645,19460.0
8572,73,68,13,20,145,144,154,153,173,299,297,22330,3338335.0,22032,22200.75
8573,44,35,10,23,132,131,73,72,50,205,203,9636,987690.0,9432,10403.75
8574,74,64,26,42,362,361,197,196,851,559,557,71314,19932263.0,70756,77840.75
8575,42,36,11,20,171,170,170,169,189,341,339,29070,4956435.0,28730,28899.75
8576,18,16,3,4,200,199,239,238,301,439,437,47800,10492100.0,47362,47960.75
8577,137,118,49,84,304,303,331,330,1749,635,633,100624,31948120.0,99990,100488.75
8578,67,57,18,36,180,179,254,253,317,434,432,45720,9921240.0,45287,46872.0
8579,69,62,14,26,195,194,128,127,152,323,321,24960,4031040.0,24638,25920.75
858,355,341,20,46,377,376,405,404,2427,782,780,152685,59699835.0,151904,152490.0
8580,54,43,22,41,261,260,258,257,433,519,517,67338,17474211.0,66820,67080.75
8582,81,69,29,51,378,377,338,337,1404,716,714,127764,45739512.0,127049,127806.0
8583,45,40,16,23,128,127,175,174,144,303,301,22400,3393600.0,22098,22800.75
8584,42,36,7,15,109,108,183,182,181,292,290,19947,2912262.0,19656,21170.0
8585,79,61,22,53,214,213,124,123,177,338,336,26536,4484584.0,26199,28392.0
8586,55,44,18,38,119,118,125,124,86,244,242,14875,1814750.0,14632,14762.0
8587,71,59,25,46,225,224,286,285,460,511,509,64350,16441425.0,63840,65024.75
8588,80,61,33,69,203,202,223,222,374,426,424,45269,9642297.0,44844,45156.0
8589,45,36,19,35,95,94,140,139,74,235,233,13300,1562750.0,13066,13688.75
859,53,47,11,19,95,94,161,160,145,256,254,15295,1957760.0,15040,16256.0
8590,20,17,7,11,111,110,85,84,52,196,194,9435,924630.0,9240,9506.0
8591,44,37,14,22,96,95,168,167,87,264,262,16128,2128896.0,15865,17292.0
8592,139,138,6,6,147,146,262,261,346,409,407,38514,7876113.0,38106,41615.75
8593,155,128,49,99,402,401,439,438,2607,841,839,176478,74208999.0,175638,176399.75
8594,52,47,16,23,143,142,289,288,339,432,430,41327,8926632.0,40896,46440.0
8595,120,112,20,34,188,187,243,242,463,431,429,45684,9844902.0,45254,46224.75
8596,36,31,14,22,269,268,159,158,265,428,426,42771,9152994.0,42344,45582.0
8597,120,108,25,47,265,264,246,245,793,511,509,65190,16656045.0,64680,65024.75
8598,153,121,50,111,319,318,359,358,1169,678,676,114521,38822619.0,113844,114582.0
8599,69,58,22,42,142,141,222,221,189,364,362,31524,5737368.0,31161,32942.0
86,109,90,28,64,184,183,250,249,371,434,432,46000,9982000.0,45567,46872.0
860,70,61,28,44,193,192,227,226,322,420,418,43811,9200310.0,43392,43890.0
8600,36,32,14,20,134,133,128,127,88,262,260,17152,2246912.0,16891,17030.0
8601,100,80,31,68,278,277,193,192,417,471,469,53654,12635517.0,53184,55224.75
8602,37,26,8,28,257,256,173,172,335,430,428,44461,9559115.0,44032,46010.0
8603,43,37,13,23,288,287,162,161,360,450,448,46656,10497600.0,46207,50400.0
8604,257,256,10,10,267,266,267,266,589,534,532,71289,19034163.0,70756,71022.0
8605,68,50,13,45,148,147,146,145,137,294,292,21608,3176376.0,21315,21462.0
8606,46,34,17,38,79,78,128,127,54,207,205,10112,1046592.0,9906,10608.75
8607,36,31,11,17,186,185,126,125,137,312,310,23436,3656016.0,23125,24180.0
8608,23,20,3,5,105,104,93,92,44,198,196,9765,966735.0,9568,9702.0
8609,58,46,20,40,196,195,195,194,236,391,389,38220,7472010.0,37830,38024.75
861,31,26,10,17,140,139,167,166,194,307,305,23380,3588830.0,23074,23408.75
8610,100,91,19,35,164,163,197,196,253,361,359,32308,5831594.0,31948,32399.75
8611,58,51,15,25,124,123,152,151,115,276,274,18848,2601024.0,18573,18906.0
8612,61,46,15,41,133,132,111,110,125,244,242,14763,1801086.0,14520,14762.0
8613,56,46,19,36,153,152,177,176,138,330,328,27081,4468365.0,26752,27060.0
8614,45,36,11,27,105,104,139,138,85,244,242,14595,1780590.0,14352,14762.0
8615,78,61,22,53,174,173,175,174,222,349,347,30450,5313525.0,30102,30275.75
8616,43,38,15,21,110,109,146,145,90,256,254,16060,2055680.0,15805,16256.0
8617,65,50,23,50,231,230,267,266,676,498,496,61677,15357573.0,61180,61752.0
8618,51,48,11,15,91,90,126,125,50,217,215,11466,1244061.0,11250,11663.75
8619,74,67,18,28,137,136,130,129,75,267,265,17810,2377635.0,17544,17688.75
862,48,45,14,18,120,119,86,85,54,206,204,10320,1062960.0,10115,10506.0
8620,38,32,12,21,77,76,150,149,77,227,225,11550,1310925.0,11324,12768.75
8621,69,55,21,46,153,152,140,139,127,293,291,21420,3138030.0,21128,21315.75
8622,36,33,13,17,236,235,123,122,159,359,357,29028,5210526.0,28670,32040.75
8623,62,54,17,30,149,148,135,134,101,284,282,20115,2856330.0,19832,20022.0
8624,79,73,19,29,246,245,164,163,252,410,408,40344,8270520.0,39935,41820.0
8625,49,41,13,25,129,128,150,149,114,279,277,19350,2699325.0,19072,19320.75
8626,84,71,23,45,161,160,213,212,198,374,372,34293,6412791.0,33920,34782.0
8627,63,54,13,28,129,128,205,204,207,334,332,26445,4416315.0,26112,27722.0
8628,48,44,11,17,175,174,94,93,72,269,267,16450,2212525.0,16182,17955.75
8629,45,40,17,24,196,195,329,328,504,525,523,64484,16927050.0,63960,68643.75
863,104,84,23,61,312,311,267,266,754,579,577,83304,24116508.0,82726,83520.75
8630,93,76,22,50,199,198,271,270,587,470,468,53929,12673315.0,53460,54990.0
8631,35,31,9,15,197,196,147,146,149,344,342,28959,4980948.0,28616,29412.0
8632,56,51,12,19,93,92,190,189,106,283,281,17670,2500305.0,17388,19880.75
8633,56,51,13,18,120,119,194,193,170,314,312,23280,3654960.0,22967,24492.0
8634,77,62,25,52,165,164,169,168,202,334,332,27885,4656795.0,27552,27722.0
8635,35,32,15,18,173,172,181,180,209,354,352,31313,5542401.0,30960,31152.0
8636,37,35,11,13,155,154,141,140,115,296,294,21855,3234540.0,21560,21756.0
8637,126,113,35,58,351,350,185,184,443,536,534,64935,17402580.0,64400,71556.0
8638,62,53,17,31,187,186,194,193,236,381,379,36278,6910959.0,35898,36099.75
864,57,38,21,57,168,167,160,159,212,328,326,26880,4408320.0,26553,26732.0
8640,44,41,14,18,123,122,106,105,67,229,227,13038,1492851.0,12810,12995.75
8641,59,55,18,23,171,170,181,180,179,352,350,30951,5447376.0,30600,30800.0
8642,61,52,23,39,284,283,224,223,533,508,506,63616,16158464.0,63109,64262.0
8644,114,96,43,77,485,484,410,409,3735,895,893,198850,88985375.0,197956,199808.75
8645,45,33,14,35,253,252,274,273,779,527,525,69322,18266347.0,68796,69168.75
8646,77,52,22,69,180,179,267,266,502,447,445,48060,10741410.0,47614,49728.75
8647,117,99,33,66,330,329,407,406,2076,737,735,134310,49493235.0,133574,135423.75
8649,52,47,18,24,155,154,275,274,376,430,428,42625,9164375.0,42196,46010.0
865,79,65,26,52,177,176,162,161,172,339,337,28674,4860243.0,28336,28560.75
8651,111,94,38,70,321,320,328,327,1162,649,647,105288,34165956.0,104640,104975.75
8652,72,66,22,32,266,265,205,204,623,471,469,54530,12841815.0,54060,55224.75
8653,53,39,14,40,120,119,108,107,91,228,226,12960,1477440.0,12733,12882.0
8654,40,31,12,28,141,140,194,193,223,335,333,27354,4581795.0,27020,27888.75
8655,32,27,10,18,160,159,81,80,60,241,239,12960,1561680.0,12720,14399.75
8656,70,59,21,41,151,150,124,123,87,275,273,18724,2574550.0,18450,18768.75
8657,48,44,12,18,98,97,237,236,242,335,333,23226,3890355.0,22892,27888.75
8658,68,58,16,33,119,118,169,168,99,288,286,20111,2895984.0,19824,20592.0
8659,60,51,13,29,179,178,131,130,122,310,308,23449,3634595.0,23140,23870.0
866,75,70,19,27,133,132,172,171,132,305,303,22876,3488590.0,22572,23103.75
8660,257,256,10,10,267,266,267,266,598,534,532,71289,19034163.0,70756,71022.0
8661,48,40,16,28,214,213,325,324,915,539,537,69550,18743725.0,69012,72360.75
8662,66,59,25,36,152,151,151,150,169,303,301,22952,3477228.0,22650,22800.75
8663,69,58,24,44,468,467,384,383,1807,852,850,179712,76557312.0,178861,181050.0
8664,75,66,22,37,224,223,180,179,300,404,402,40320,8144640.0,39917,40602.0
8665,112,87,33,77,283,282,317,316,833,600,598,89711,26913300.0,89112,89700.0
8666,80,67,24,48,217,216,150,149,209,367,365,32550,5972925.0,32184,33488.75
8667,57,56,7,7,127,126,120,119,90,247,245,15240,1882140.0,14994,15128.75
8668,64,57,22,32,286,285,161,160,394,447,445,46046,10291281.0,45600,49728.75
8669,99,86,22,44,178,177,250,249,313,428,426,44500,9523000.0,44073,45582.0
867,50,42,12,26,154,153,280,279,354,434,432,43120,9357040.0,42687,46872.0
8670,47,35,14,36,100,99,155,154,103,255,253,15500,1976250.0,15246,16128.75
8671,49,42,16,28,139,138,136,135,131,275,273,18904,2599300.0,18630,18768.75
8672,39,31,13,25,115,114,188,187,151,303,301,21620,3275430.0,21318,22800.75
8673,40,34,13,23,129,128,176,175,123,305,303,22704,3462360.0,22400,23103.75
8674,28,26,7,9,249,248,420,419,1157,669,667,104580,34982010.0,103912,111555.75
8675,164,137,56,107,419,418,526,525,5160,945,943,220394,104136165.0,219450,222783.75
8676,53,46,17,29,148,147,99,98,87,247,245,14652,1809522.0,14406,15128.75
8677,52,47,17,24,251,250,273,272,520,524,522,68523,17953026.0,68000,68382.0
8679,54,45,18,30,192,191,152,151,181,344,342,29184,5019648.0,28841,29412.0
868,82,63,26,62,148,147,285,284,430,433,431,42180,9131970.0,41748,46655.75
8680,61,54,16,27,123,122,105,104,82,228,226,12915,1472310.0,12688,12882.0
8681,55,40,17,42,110,109,142,141,148,252,250,15620,1968120.0,15369,15750.0
8682,50,43,13,25,95,94,131,130,66,226,224,12445,1406285.0,12220,12656.0
8683,36,28,8,21,208,207,180,179,350,388,386,37440,7263360.0,37053,37442.0
8684,38,24,10,31,272,271,253,252,587,525,523,68816,18064200.0,68292,68643.75
8685,45,34,11,30,186,185,152,151,182,338,336,28272,4777968.0,27935,28392.0
8686,63,57,18,26,203,202,155,154,221,358,356,31465,5632235.0,31108,31862.0
8687,105,84,35,71,301,300,377,376,1348,678,676,113477,38468703.0,112800,114582.0
8688,67,60,21,33,315,314,222,221,789,537,535,69930,18776205.0,69394,71823.75
8689,47,35,13,32,191,190,143,142,198,334,332,27313,4561271.0,26980,27722.0
869,30,19,5,15,114,113,80,79,54,194,192,9120,884640.0,8927,9312.0
8690,82,63,22,56,179,178,158,157,187,337,335,28282,4765517.0,27946,28223.75
8691,88,69,23,59,299,298,390,389,1290,689,687,116610,40172145.0,115922,118335.75
8692,75,68,13,25,152,151,181,180,154,333,331,27512,4580748.0,27180,27555.75
8693,51,45,14,23,130,129,156,155,133,286,284,20280,2900040.0,19995,20306.0
8694,58,47,21,41,246,245,119,118,192,365,363,29274,5342505.0,28910,33123.75
8695,54,46,18,32,135,134,160,159,131,295,293,21600,3186000.0,21306,21608.75
8696,74,59,26,52,221,220,340,339,617,561,559,75140,21076770.0,74580,78399.75
8697,67,57,19,36,201,200,180,179,358,381,379,36180,6892290.0,35800,36099.75
8698,95,71,28,74,266,265,267,266,698,533,531,71022,18927363.0,70490,70755.75
8699,85,78,22,34,110,109,149,148,80,259,257,16390,2122505.0,16132,16640.75
87,46,43,17,21,118,117,136,135,82,254,252,16048,2038096.0,15795,16002.0
870,39,35,8,14,143,142,142,141,103,285,283,20306,2893605.0,20022,20163.75
8700,77,56,27,65,467,466,399,398,3587,866,864,186333,80682189.0,185468,187056.0
8701,50,39,14,33,177,176,144,143,139,321,319,25488,4090824.0,25168,25599.75
8702,49,32,13,44,102,101,127,126,104,229,227,12954,1483233.0,12726,12995.75
8703,46,41,16,22,134,133,187,186,156,321,319,25058,4021809.0,24738,25599.75
8704,78,61,24,55,242,241,260,259,486,502,500,62920,15792920.0,62419,62750.0
8705,46,39,12,22,142,141,126,125,83,268,266,17892,2397528.0,17625,17822.0
8706,30,26,9,15,184,183,228,227,333,412,410,41952,8642112.0,41541,42230.0
8707,102,91,22,41,275,274,189,188,560,464,462,51975,12058200.0,51512,53592.0
8708,46,41,15,23,258,257,297,296,1032,555,553,76626,21263715.0,76072,76728.75
8709,68,61,22,34,136,135,178,177,124,314,312,24208,3800656.0,23895,24492.0
871,68,62,17,27,109,108,129,128,64,238,236,14061,1673259.0,13824,14042.0
8710,37,26,10,24,109,108,104,103,90,213,211,11336,1207284.0,11124,11235.75
8711,138,114,41,85,368,367,354,353,1701,722,720,130272,47028192.0,129551,129960.0
8712,35,31,11,15,114,113,98,97,75,212,210,11172,1184232.0,10961,11130.0
8713,29,28,9,9,267,266,122,121,245,389,387,32574,6335643.0,32186,37635.75
8714,163,135,59,113,337,336,477,476,2565,814,812,160749,65424843.0,159936,165242.0
8715,97,74,30,74,151,150,188,187,273,339,337,28388,4811766.0,28050,28560.75
8716,104,86,33,67,234,233,367,366,1062,601,599,85878,25806339.0,85278,89999.75
8717,78,71,19,31,177,176,205,204,198,382,380,36285,6930435.0,35904,36290.0
8718,44,38,15,25,228,227,123,122,170,351,349,28044,4921722.0,27694,30624.75
8719,105,82,30,72,221,220,314,313,708,535,533,69394,18562895.0,68860,71288.75
872,61,54,17,28,121,120,137,136,142,258,256,16577,2138433.0,16320,16512.0
8720,58,45,12,30,97,96,161,160,96,258,256,15617,2014593.0,15360,16512.0
8722,34,30,7,12,160,159,217,216,227,377,375,34720,6544720.0,34344,35343.75
8723,64,52,22,44,205,204,155,154,195,360,358,31775,5719500.0,31416,32220.0
8724,29,28,8,8,153,152,129,128,129,282,280,19737,2782917.0,19456,19740.0
8725,57,49,15,28,143,142,164,163,154,307,305,23452,3599882.0,23146,23408.75
8726,80,57,25,68,304,303,243,242,656,547,545,73872,20203992.0,73326,74528.75
8727,230,200,63,121,428,427,528,527,2976,956,954,225984,108020352.0,225029,228006.0
8728,39,32,14,25,165,164,104,103,82,269,267,17160,2308020.0,16892,17955.75
8729,41,35,14,24,143,142,254,253,230,397,395,36322,7209917.0,35926,39203.75
873,61,51,18,35,279,278,396,395,1037,675,673,110484,37288350.0,109810,113568.75
8730,110,84,39,89,273,272,417,416,1466,690,688,113841,39275145.0,113152,118680.0
8731,18,16,5,6,175,174,184,183,186,359,357,32200,5779900.0,31842,32040.75
8732,84,78,28,37,169,168,220,219,231,389,387,37180,7231510.0,36792,37635.75
8733,64,53,18,37,204,203,181,180,284,385,383,36924,7107870.0,36540,36863.75
8735,35,29,14,24,177,176,358,357,674,535,533,63366,16950405.0,62832,71288.75
8736,114,83,32,80,227,226,230,229,484,457,455,52210,11929985.0,51754,51983.75
8737,52,40,23,45,184,183,317,316,585,501,499,58328,14611164.0,57828,62499.75
8738,78,66,25,46,318,317,173,172,510,491,489,55014,13505937.0,54524,60024.75
8739,48,39,9,23,115,114,96,95,50,211,209,11040,1164720.0,10830,11024.75
874,66,53,19,39,229,228,388,387,1044,617,615,88852,27410842.0,88236,94863.75
8740,92,77,30,58,212,211,317,316,995,529,527,67204,17775458.0,66676,69695.75
8741,37,33,13,19,117,116,201,200,129,318,316,23517,3739203.0,23200,25122.0
8742,37,30,13,22,108,107,119,118,91,227,225,12852,1458702.0,12626,12768.75
8743,46,38,14,28,116,115,140,139,85,256,254,16240,2078720.0,15985,16256.0
8744,70,60,15,31,151,150,123,122,129,274,272,18573,2544501.0,18300,18632.0
8745,58,48,15,33,148,147,159,158,147,307,305,23532,3612162.0,23226,23408.75
8746,79,72,11,22,116,115,115,114,79,231,229,13340,1540770.0,13110,13224.75
8747,33,28,12,19,241,240,270,269,450,511,509,65070,16625385.0,64560,65024.75
8748,51,32,9,38,107,106,126,125,114,233,231,13482,1570653.0,13250,13455.75
8749,66,59,19,28,240,239,196,195,276,436,434,47040,10254720.0,46605,47306.0
875,79,63,15,45,159,158,160,159,172,319,317,25440,4057680.0,25122,25280.75
8750,54,47,19,29,129,128,236,235,194,365,363,30444,5556030.0,30080,33123.75
8751,222,220,11,13,239,238,354,353,1192,593,591,84606,25085679.0,84014,87615.75
8752,109,86,30,73,324,323,266,265,977,590,588,86184,25424280.0,85595,86730.0
8753,91,82,26,42,166,165,259,258,326,425,423,42994,9136225.0,42570,44943.75
8754,42,33,11,26,220,219,341,340,883,561,559,75020,21043110.0,74460,78399.75
8755,85,66,25,61,248,247,159,158,357,407,405,39432,8024412.0,39026,41208.75
8756,72,61,21,40,151,150,188,187,195,339,337,28388,4811766.0,28050,28560.75
8757,54,45,13,27,111,110,217,216,142,328,326,24087,3950268.0,23760,26732.0
8758,72,60,26,48,153,152,181,180,250,334,332,27693,4624731.0,27360,27722.0
8759,65,46,19,54,154,153,157,156,169,311,309,24178,3759679.0,23868,24024.75
876,138,119,43,79,335,334,289,288,989,624,622,96815,30206280.0,96192,97032.0
8760,110,96,29,54,267,266,180,179,377,447,445,48060,10741410.0,47614,49728.75
8761,59,45,14,37,200,199,131,130,137,331,329,26200,4336100.0,25870,27224.75
8762,58,37,15,55,218,217,180,179,265,398,396,39240,7808760.0,38843,39402.0
8764,37,25,12,32,94,93,120,119,81,214,212,11280,1206960.0,11067,11342.0
8765,63,54,21,36,120,119,132,131,80,252,250,15840,1995840.0,15589,15750.0
8766,43,39,8,11,109,108,137,136,91,246,244,14933,1836759.0,14688,15006.0
8767,78,71,17,25,107,106,159,158,79,266,264,17013,2262729.0,16748,17556.0
8768,34,24,13,31,89,88,145,144,60,234,232,12905,1509885.0,12672,13572.0
877,43,35,14,27,171,170,113,112,109,284,282,19323,2743866.0,19040,20022.0
8770,38,32,15,25,213,212,141,140,227,354,352,30033,5315841.0,29680,31152.0
8771,64,56,14,27,113,112,220,219,153,333,331,24860,4139190.0,24528,27555.75
8773,45,35,15,32,204,203,125,124,138,329,327,25500,4194750.0,25172,26895.75
8774,41,34,13,21,159,158,119,118,102,278,276,18921,2630019.0,18644,19182.0
8775,391,381,13,31,405,404,405,404,3012,810,808,164025,66430125.0,163216,163620.0
8776,57,44,19,41,126,125,138,137,84,264,262,17388,2295216.0,17125,17292.0
8777,47,41,20,29,173,172,113,112,88,286,284,19549,2795507.0,19264,20306.0
8778,71,59,21,43,237,236,295,294,646,532,530,69915,18597390.0,69384,70490.0
8779,99,87,33,55,222,221,364,363,758,586,584,80808,23676744.0,80223,85556.0
878,73,55,27,60,249,248,383,382,827,632,630,95367,30135972.0,94736,99540.0
8780,58,43,24,52,291,290,177,176,533,468,466,51507,12052638.0,51040,54522.0
8781,24,22,6,7,180,179,124,123,116,304,302,22320,3392640.0,22017,22952.0
8782,70,56,23,49,216,215,377,376,822,593,591,81432,24144588.0,80840,87615.75
8783,87,73,23,47,279,278,138,137,287,417,415,38502,8027667.0,38086,43263.75
8784,61,58,7,10,183,182,155,154,199,338,336,28365,4793685.0,28028,28392.0
8785,45,37,17,29,427,426,229,228,913,656,654,97783,32072824.0,97128,107256.0
8786,92,73,35,70,371,370,331,330,1522,702,700,122801,43103151.0,122100,122850.0
8787,45,39,17,27,92,91,143,142,86,235,233,13156,1545830.0,12922,13688.75
8788,57,52,17,24,125,124,157,156,167,282,280,19625,2767125.0,19344,19740.0
8789,58,51,11,18,224,223,135,134,238,359,357,30240,5428080.0,29882,32040.75
879,66,56,20,38,241,240,316,315,537,557,555,76156,21209446.0,75600,77283.75
8790,52,44,12,23,116,115,179,178,121,295,293,20764,3062690.0,20470,21608.75
8791,48,41,13,24,170,169,222,221,225,392,390,37740,7397040.0,37349,38220.0
8792,69,57,23,45,216,215,257,256,523,473,471,55512,13128588.0,55040,55695.75
8793,26,24,9,10,104,103,142,141,74,246,244,14768,1816464.0,14523,15006.0
8794,50,44,17,27,128,127,257,256,204,385,383,32896,6332480.0,32512,36863.75
8795,53,47,18,25,220,219,184,183,500,404,402,40480,8176960.0,40077,40602.0
8796,44,40,9,15,104,103,209,208,188,313,311,21736,3401684.0,21424,24335.75
8797,23,15,5,14,107,106,148,147,95,255,253,15836,2019090.0,15582,16128.75
8798,52,41,18,38,210,209,136,135,203,346,344,28560,4940880.0,28215,29756.0
8799,57,54,12,16,147,146,114,113,100,261,259,16758,2186919.0,16498,16899.75
88,83,78,18,26,143,142,120,119,92,263,261,17160,2256540.0,16898,17160.75
880,64,57,13,25,127,126,125,124,73,252,250,15875,2000250.0,15624,15750.0
8800,65,50,19,41,174,173,199,198,188,373,371,34626,6457749.0,34254,34595.75
8801,101,82,32,68,183,182,247,246,313,430,428,45201,9718215.0,44772,46010.0
8802,42,31,12,26,167,166,108,107,116,275,273,18036,2479950.0,17762,18768.75
8803,57,52,14,22,179,178,192,191,187,371,369,34368,6375264.0,33998,34224.75
8804,70,59,26,43,226,225,113,112,155,339,337,25538,4328691.0,25200,28560.75
8805,63,40,15,56,269,268,157,156,396,426,424,42233,8995629.0,41808,45156.0
8806,57,53,14,19,180,179,110,109,107,290,288,19800,2871000.0,19511,20880.0
8807,53,48,12,20,108,107,77,76,36,185,183,8316,769230.0,8132,8463.75
8808,82,62,28,61,275,274,187,186,349,462,460,51425,11879175.0,50964,53130.0
8809,28,25,10,12,110,109,155,154,91,265,263,17050,2259125.0,16786,17423.75
8810,73,65,14,28,148,147,172,171,132,320,318,25456,4072960.0,25137,25440.0
8811,35,33,12,14,138,137,167,166,154,305,303,23046,3514515.0,22742,23103.75
8812,75,59,23,51,199,198,185,184,256,384,382,36815,7068480.0,36432,36672.0
8813,55,48,17,29,144,143,144,143,175,288,286,20736,2985984.0,20449,20592.0
8815,70,62,12,25,171,170,194,193,239,365,363,33174,6054255.0,32810,33123.75
8816,65,50,19,47,200,199,218,217,254,418,416,43600,9112400.0,43183,43472.0
8817,257,256,10,10,267,266,267,266,562,534,532,71289,19034163.0,70756,71022.0
8818,45,39,14,24,138,137,232,231,206,370,368,32016,5922960.0,31647,34040.0
8819,107,91,32,62,265,264,229,228,475,494,492,60685,14989195.0,60192,60762.0
882,81,70,24,44,176,175,196,195,185,372,370,34496,6416256.0,34125,34410.0
8820,53,44,16,32,97,96,134,133,79,231,229,12998,1501269.0,12768,13224.75
8821,65,48,18,50,138,137,146,145,133,284,282,20148,2861016.0,19865,20022.0
8822,113,96,37,69,333,332,330,329,1307,663,661,109890,36428535.0,109228,109560.75
8823,57,48,21,37,184,183,329,328,484,513,511,60536,15527484.0,60024,65535.75
8824,49,39,15,32,178,177,109,108,118,287,285,19402,2784187.0,19116,20448.75
8825,58,49,14,24,176,175,224,223,369,400,398,39424,7884800.0,39025,39800.0
8826,52,39,18,41,322,321,396,395,1861,718,716,127512,45776808.0,126795,128522.0
8827,38,32,13,23,85,84,119,118,63,204,202,10115,1031730.0,9912,10302.0
8828,57,49,19,32,247,246,183,182,360,430,428,45201,9718215.0,44772,46010.0
8829,33,27,11,20,165,164,98,97,81,263,261,16170,2126355.0,15908,17160.75
883,91,79,22,41,184,183,174,173,203,358,356,32016,5730864.0,31659,31862.0
8830,49,42,20,31,178,177,151,150,139,329,327,26878,4421431.0,26550,26895.75
8831,38,34,9,14,84,83,122,121,65,206,204,10248,1055544.0,10043,10506.0
8832,28,24,12,15,141,140,260,259,274,401,399,36660,7350330.0,36260,39999.75
8833,66,62,19,24,379,378,483,482,3481,862,860,183057,78897567.0,182196,185330.0
8835,119,118,6,6,124,123,170,169,111,294,292,21080,3098760.0,20787,21462.0
8836,42,36,13,22,100,99,121,120,58,221,219,12100,1337050.0,11880,12099.75
8837,34,30,13,17,183,182,200,199,379,383,381,36600,7008900.0,36218,36480.75
8838,69,62,24,36,204,203,329,328,645,533,531,67116,17886414.0,66584,70755.75
8839,67,56,22,42,238,237,227,226,444,465,463,54026,12561045.0,53562,53823.75
884,58,47,19,39,137,136,332,331,361,469,467,45484,10665998.0,45016,54755.75
8840,257,256,10,10,267,266,267,266,578,534,532,71289,19034163.0,70756,71022.0
8841,68,50,20,51,240,239,169,168,249,409,407,40560,8294520.0,40152,41615.75
8842,83,68,23,51,200,199,166,165,240,366,364,33200,6075600.0,32835,33306.0
8843,66,53,17,40,209,208,183,182,244,392,390,38247,7496412.0,37856,38220.0
8844,106,80,26,76,396,395,251,250,1056,647,645,99396,32154606.0,98750,104328.75
8846,62,54,24,38,194,193,161,160,171,355,353,31234,5544035.0,30880,31328.75
8847,47,35,15,37,129,128,165,164,131,294,292,21285,3128895.0,20992,21462.0
8848,105,85,28,66,295,294,165,164,326,460,458,48675,11195250.0,48216,52670.0
8849,62,48,21,46,264,263,200,199,424,464,462,52800,12249600.0,52337,53592.0
885,66,59,20,32,227,226,177,176,259,404,402,40179,8116158.0,39776,40602.0
8850,38,34,13,19,133,132,203,202,174,336,334,26999,4535832.0,26664,28056.0
8851,171,138,62,126,404,403,475,474,2935,879,877,191900,84340050.0,191022,192720.75
8852,37,31,13,23,106,105,103,102,40,209,207,10918,1140931.0,10710,10815.75
8853,143,122,47,86,420,419,512,511,3399,932,930,215040,100208640.0,214109,216690.0
8854,41,32,15,30,125,124,128,127,81,253,251,16000,2024000.0,15748,15875.75
8855,41,37,11,17,143,142,71,70,43,214,212,10153,1086371.0,9940,11342.0
8856,46,41,10,14,174,173,139,138,175,313,311,24186,3785109.0,23874,24335.75
8857,78,71,11,22,138,137,113,112,145,251,249,15594,1957047.0,15344,15624.75
8859,56,43,15,38,157,156,107,106,114,264,262,16799,2217468.0,16536,17292.0
886,63,56,22,32,121,120,194,193,196,315,313,23474,3697155.0,23160,24648.75
8860,21,20,5,5,206,205,102,101,119,308,306,21012,3235848.0,20705,23562.0
8861,73,59,20,46,129,128,147,146,105,276,274,18963,2616894.0,18688,18906.0
8862,45,37,15,25,145,144,112,111,108,257,255,16240,2086840.0,15984,16383.75
8863,57,46,10,29,111,110,148,147,92,259,257,16428,2127426.0,16170,16640.75
8864,257,256,10,10,267,266,267,266,612,534,532,71289,19034163.0,70756,71022.0
8865,76,61,20,48,144,143,165,164,133,309,307,23760,3670920.0,23452,23715.75
8866,52,46,15,22,180,179,149,148,168,329,327,26820,4411890.0,26492,26895.75
8867,78,67,19,39,127,126,219,218,163,346,344,27813,4811649.0,27468,29756.0
8868,105,100,10,18,178,177,124,123,115,302,300,22072,3332872.0,21771,22650.0
887,122,109,35,58,230,229,229,228,514,459,457,52670,12087765.0,52212,52440.75
8870,44,29,17,41,130,129,183,182,157,313,311,23790,3723135.0,23478,24335.75
8871,56,46,10,25,120,119,101,100,83,221,219,12120,1339260.0,11900,12099.75
8872,41,36,12,19,103,102,183,182,116,286,284,18849,2695407.0,18564,20306.0
8873,55,44,16,28,258,257,178,177,408,436,434,45924,10011432.0,45489,47306.0
8874,66,59,16,28,130,129,132,131,82,262,260,17160,2247960.0,16899,17030.0
8875,79,66,26,50,226,225,330,329,812,556,554,74580,20733240.0,74025,77006.0
8876,65,54,18,37,175,174,103,102,98,278,276,18025,2505475.0,17748,19182.0
8877,56,49,14,26,148,147,164,163,172,312,310,24272,3786432.0,23961,24180.0
8878,84,68,23,52,183,182,276,275,349,459,457,50508,11591586.0,50050,52440.75
8879,53,49,12,18,94,93,198,197,102,292,290,18612,2717352.0,18321,21170.0
888,17,16,3,3,141,140,153,152,107,294,292,21573,3171231.0,21280,21462.0
8880,40,35,13,21,164,163,145,144,182,309,307,23780,3674010.0,23472,23715.75
8881,61,50,19,36,126,125,124,123,85,250,248,15624,1953000.0,15375,15500.0
8882,24,21,9,13,142,141,61,60,37,203,201,8662,879193.0,8460,10200.75
8883,119,118,6,6,170,169,147,146,160,317,315,24990,3960915.0,24674,24963.75
8884,20,19,6,6,144,143,131,130,111,275,273,18864,2593800.0,18590,18768.75
8885,45,38,12,24,134,133,97,96,60,231,229,12998,1501269.0,12768,13224.75
8886,91,69,37,79,262,261,282,281,520,544,542,73884,20096448.0,73341,73712.0
8887,60,51,22,37,154,153,213,212,236,367,365,32802,6019167.0,32436,33488.75
8888,55,47,15,28,104,103,125,124,95,229,227,13000,1488500.0,12772,12995.75
8889,70,54,28,53,327,326,248,247,700,575,573,81096,23315100.0,80522,82368.75
889,160,156,21,27,198,197,275,274,471,473,471,54450,12877425.0,53978,55695.75
8890,23,20,4,8,180,179,96,95,92,276,274,17280,2384640.0,17005,18906.0
8891,62,44,20,53,128,127,142,141,109,270,268,18176,2453760.0,17907,18090.0
8893,46,41,13,20,117,116,162,161,105,279,277,18954,2644083.0,18676,19320.75
8894,54,45,13,26,114,113,99,98,51,213,211,11286,1201959.0,11074,11235.75
8895,44,40,16,21,156,155,133,132,125,289,287,20748,2998086.0,20460,20735.75
8896,85,65,26,63,267,266,406,405,1307,673,671,108402,36477273.0,107730,112895.75
8897,61,52,22,38,162,161,108,107,96,270,268,17496,2361960.0,17227,18090.0
8898,26,19,6,12,175,174,258,257,324,433,431,45150,9774975.0,44718,46655.75
8899,80,61,13,48,134,133,252,251,280,386,384,33768,6517224.0,33383,37056.0
89,64,46,20,54,168,167,148,147,172,316,314,24864,3928512.0,24549,24806.0
890,173,143,45,103,548,547,453,452,3763,1001,999,248244,124246122.0,247244,249999.75
8900,90,77,30,54,258,257,353,352,775,611,609,91074,27823107.0,90464,93024.75
8901,84,64,23,61,147,146,171,170,231,318,316,25137,3996783.0,24820,25122.0
8902,57,53,11,16,116,115,104,103,64,220,218,12064,1327040.0,11845,11990.0
8903,29,26,7,10,162,161,130,129,117,292,290,21060,3074760.0,20769,21170.0
8904,37,34,13,17,86,85,159,158,79,245,243,13674,1675065.0,13430,14883.75
8905,71,63,19,32,226,225,245,244,403,471,469,55370,13039635.0,54900,55224.75
8906,71,64,17,27,146,145,163,162,135,309,307,23798,3676791.0,23490,23715.75
8907,79,73,19,29,137,136,164,163,150,301,299,22468,3381434.0,22168,22499.75
8908,71,61,20,36,142,141,216,215,203,358,356,30672,5490288.0,30315,31862.0
8909,40,32,11,25,82,81,135,134,51,217,215,11070,1201095.0,10854,11663.75
891,67,60,20,32,147,146,152,151,113,299,297,22344,3340428.0,22046,22200.75
8910,35,28,11,22,124,123,74,73,48,198,196,9176,908424.0,8979,9702.0
8912,38,33,13,19,201,200,98,97,120,299,297,19698,2944851.0,19400,22200.75
8913,35,28,11,19,191,190,117,116,134,308,306,22347,3441438.0,22040,23562.0
8914,66,58,18,32,158,157,148,147,135,306,304,23384,3577752.0,23079,23256.0
8915,40,34,10,15,184,183,192,191,229,376,374,35328,6641664.0,34953,35156.0
8916,51,44,11,22,81,80,162,161,77,243,241,13122,1594323.0,12880,14640.75
8917,55,44,19,37,159,158,224,223,232,383,381,35616,6820464.0,35234,36480.75
8918,45,38,12,23,187,186,152,151,154,339,337,28424,4817868.0,28086,28560.75
8919,18,17,5,5,106,105,197,196,121,303,301,20882,3163623.0,20580,22800.75
892,112,101,36,56,455,454,335,334,2430,790,788,152425,60207875.0,151636,155630.0
8920,67,48,22,58,158,157,127,126,134,285,283,20066,2859405.0,19782,20163.75
8921,59,51,14,27,238,237,135,134,254,373,371,32130,5992245.0,31758,34595.75
8922,64,54,20,38,111,110,252,251,185,363,361,27972,5076918.0,27610,32760.75
8923,60,48,17,37,157,156,161,160,194,318,316,25277,4019043.0,24960,25122.0
8924,66,54,24,42,194,193,169,168,232,363,361,32786,5950659.0,32424,32760.75
8925,64,55,25,40,239,238,207,206,298,446,444,49473,11032479.0,49028,49506.0
8926,162,140,47,89,396,395,346,345,2614,742,740,137016,50832936.0,136275,137270.0
8927,70,56,27,53,230,229,207,206,329,437,435,47610,10402785.0,47174,47523.75
8928,72,51,15,52,193,192,196,195,284,389,387,37828,7357546.0,37440,37635.75
8929,48,45,10,13,154,153,98,97,75,252,250,15092,1901592.0,14841,15750.0
893,65,47,18,50,248,247,154,153,359,402,400,38192,7676592.0,37791,40200.0
8930,72,59,29,50,232,231,323,322,624,555,553,74936,20794740.0,74382,76728.75
8931,44,37,10,22,87,86,164,163,68,251,249,14268,1790634.0,14018,15624.75
8932,43,32,13,31,165,164,77,76,55,242,240,12705,1537305.0,12464,14520.0
8933,52,41,17,37,176,175,117,116,93,293,291,20592,3016728.0,20300,21315.75
8934,49,41,11,24,109,108,163,162,101,272,270,17767,2416312.0,17496,18360.0
8935,74,60,19,45,129,128,120,119,91,249,247,15480,1927260.0,15232,15375.75
8936,67,55,22,38,223,222,213,212,307,436,434,47499,10354782.0,47064,47306.0
8937,147,122,45,93,323,322,491,490,1828,814,812,158593,64547351.0,157780,165242.0
8938,108,98,23,39,157,156,204,203,160,361,359,32028,5781054.0,31668,32399.75
8939,90,73,36,67,243,242,504,503,1094,747,745,122472,45743292.0,121726,139128.75
894,58,51,18,30,268,267,225,224,398,493,491,60300,14863950.0,59808,60515.75
8941,361,353,14,28,377,376,377,376,2031,754,752,142129,53582633.0,141376,141752.0
8942,108,92,29,59,358,357,176,175,457,534,532,63008,16823136.0,62475,71022.0
8944,54,47,18,30,175,174,247,246,328,422,420,43225,9120475.0,42804,44310.0
8945,22,21,7,7,184,183,86,85,75,270,268,15824,2136240.0,15555,18090.0
8946,91,75,26,53,256,255,174,173,383,430,428,44544,9576960.0,44115,46010.0
8947,28,21,6,12,120,119,152,151,97,272,270,18240,2480640.0,17969,18360.0
8948,32,25,10,18,112,111,94,93,62,206,204,10528,1084384.0,10323,10506.0
8949,37,28,14,24,148,147,266,265,334,414,412,39368,8149176.0,38955,42642.0
895,89,75,23,43,190,189,152,151,212,342,340,28880,4938480.0,28539,29070.0
8950,25,22,6,9,106,105,177,176,163,283,281,18762,2654823.0,18480,19880.75
8951,59,51,15,28,82,81,143,142,62,225,223,11726,1319175.0,11502,12543.75
8952,48,38,18,35,158,157,214,213,197,372,370,33812,6289032.0,33441,34410.0
8953,81,74,26,37,299,298,469,468,2060,768,766,140231,53848704.0,139464,147072.0
8954,39,28,7,25,147,146,79,78,59,226,224,11613,1312269.0,11388,12656.0
8955,53,48,20,28,192,191,262,261,331,454,452,50304,11419008.0,49851,51302.0
8956,49,41,11,25,108,107,128,127,76,236,234,13824,1631232.0,13589,13806.0
8957,77,70,21,33,153,152,194,193,152,347,345,29682,5149827.0,29336,29928.75
8958,59,46,16,39,104,103,126,125,69,230,228,13104,1506960.0,12875,13110.0
8959,42,35,13,24,123,122,99,98,77,222,220,12177,1351647.0,11956,12210.0
896,74,56,30,62,279,278,218,217,399,497,495,60822,15114267.0,60326,61503.75
8960,47,41,16,26,133,132,111,110,66,244,242,14763,1801086.0,14520,14762.0
8961,41,38,8,12,145,144,127,126,93,272,270,18415,2504440.0,18144,18360.0
8962,51,44,14,26,122,121,105,104,79,227,225,12810,1453935.0,12584,12768.75
8963,88,82,18,28,127,126,174,173,150,301,299,22098,3325749.0,21798,22499.75
8964,38,32,12,21,87,86,130,129,50,217,215,11310,1227135.0,11094,11663.75
8965,31,29,10,12,194,193,149,148,151,343,341,28906,4957379.0,28564,29240.75
8966,84,78,11,20,125,124,197,196,201,322,320,24625,3964625.0,24304,25760.0
8967,103,94,19,35,182,181,216,215,361,398,396,39312,7823088.0,38915,39402.0
8968,71,56,22,48,148,147,218,217,170,366,364,32264,5904312.0,31899,33306.0
8969,22,21,9,9,85,84,169,168,81,254,252,14365,1824355.0,14112,16002.0
897,79,75,24,30,143,142,182,181,158,325,323,26026,4229225.0,25702,26243.75
8970,69,59,16,32,158,157,175,174,164,333,331,27650,4603725.0,27318,27555.75
8971,40,28,11,30,177,176,124,123,123,301,299,21948,3303174.0,21648,22499.75
8972,58,50,17,31,102,101,217,216,124,319,317,22134,3530373.0,21816,25280.75
8973,36,24,9,31,103,102,121,120,87,224,222,12463,1395856.0,12240,12432.0
8974,50,38,16,36,132,131,256,255,245,388,386,33792,6555648.0,33405,37442.0
8975,70,58,21,43,127,126,177,176,127,304,302,22479,3416808.0,22176,22952.0
8976,100,95,23,30,244,243,219,218,523,463,461,53436,12370434.0,52974,53360.75
8977,72,55,23,53,211,210,159,158,216,370,368,33549,6206565.0,33180,34040.0
8978,257,256,10,10,267,266,267,266,606,534,532,71289,19034163.0,70756,71022.0
8979,81,70,33,50,163,162,179,178,167,342,340,29177,4989267.0,28836,29070.0
898,43,40,13,17,234,233,129,128,220,363,361,30186,5478759.0,29824,32760.75
8980,72,68,14,20,185,184,141,140,190,326,324,26085,4251855.0,25760,26406.0
8981,73,62,17,35,130,129,113,112,100,243,241,14690,1784835.0,14448,14640.75
8982,102,87,38,65,227,226,194,193,490,421,419,44038,9269999.0,43618,44099.75
8983,31,29,9,11,83,82,129,128,59,212,210,10707,1134942.0,10496,11130.0
8985,35,21,10,32,176,175,145,144,188,321,319,25520,4095960.0,25200,25599.75
8986,58,51,20,29,200,199,164,163,264,364,362,32800,5969600.0,32437,32942.0
8987,165,159,19,29,181,180,267,266,315,448,446,48327,10825248.0,47880,49952.0
8988,27,24,7,9,105,104,82,81,42,187,185,8610,805035.0,8424,8648.75
8989,44,36,12,23,166,165,113,112,90,279,277,18758,2616741.0,18480,19320.75
899,79,74,20,27,121,120,153,152,90,274,272,18513,2536281.0,18240,18632.0
8990,19,17,5,7,315,314,179,178,398,494,492,56385,13927095.0,55892,60762.0
8991,80,69,26,46,194,193,209,208,317,403,401,40546,8170019.0,40144,40400.75
8992,50,39,16,35,142,141,115,114,70,257,255,16330,2098405.0,16074,16383.75
8993,93,82,24,43,200,199,233,232,411,433,431,46600,10088900.0,46168,46655.75
8994,51,42,14,29,172,171,114,113,112,286,284,19608,2803944.0,19323,20306.0
8995,132,109,35,79,271,270,292,291,497,563,561,79132,22275658.0,78570,78960.75
8996,113,108,12,19,216,215,178,177,306,394,392,38448,7574256.0,38055,38612.0
8997,45,36,11,27,108,107,68,67,30,176,174,7344,646272.0,7169,7656.0
8998,73,55,17,51,144,143,150,149,134,294,292,21600,3175200.0,21307,21462.0
8999,70,62,22,33,133,132,196,195,166,329,327,26068,4288186.0,25740,26895.75
9,48,41,13,25,103,102,97,96,72,200,198,9991,999100.0,9792,9900.0
90,95,87,30,43,186,185,200,199,253,386,384,37200,7179600.0,36815,37056.0
900,41,38,11,13,142,141,211,210,164,353,351,29962,5288293.0,29610,30975.75
9000,126,116,29,47,310,309,288,287,846,598,596,89280,26694720.0,88683,89102.0
9001,73,68,18,26,103,102,194,193,132,297,295,19982,2967327.0,19686,21903.75
9002,42,33,11,27,165,164,135,134,186,300,298,22275,3341250.0,21976,22350.0
9003,48,41,13,25,169,168,128,127,129,297,295,21632,3212352.0,21336,21903.75
9004,55,41,13,39,164,163,94,93,83,258,256,15416,1988664.0,15159,16512.0
9005,31,25,9,14,136,135,239,238,238,375,373,32504,6094500.0,32130,34968.75
9006,59,52,20,32,392,391,355,354,1571,747,745,139160,51976260.0,138414,139128.75
9007,50,42,19,31,184,183,346,345,613,530,528,63664,16870960.0,63135,69960.0
9008,32,28,10,15,145,144,197,196,170,342,340,28565,4884615.0,28224,29070.0
9009,104,82,32,74,440,439,207,206,1098,647,645,91080,29464380.0,90434,104328.75
901,51,40,16,36,117,116,196,195,145,313,311,22932,3588858.0,22620,24335.75
9010,64,53,20,40,184,183,110,109,113,294,292,20240,2975280.0,19947,21462.0
9011,90,74,26,55,141,140,186,185,215,327,325,26226,4287951.0,25900,26568.75
9012,116,97,38,74,192,191,262,261,442,454,452,50304,11419008.0,49851,51302.0
9014,82,59,21,65,185,184,157,156,271,342,340,29045,4966695.0,28704,29070.0
9015,89,73,32,60,408,407,259,258,1542,667,665,105672,35241612.0,105006,110888.75
9016,126,120,13,22,178,177,170,169,212,348,346,30260,5265240.0,29913,30102.0
9017,18,16,5,7,93,92,92,91,37,185,183,8556,791430.0,8372,8463.75
9019,62,58,16,22,166,165,120,119,117,286,284,19920,2848560.0,19635,20306.0
902,51,40,17,37,151,150,120,119,132,271,269,18120,2455260.0,17850,18224.75
9021,127,116,13,33,170,169,178,177,261,348,346,30260,5265240.0,29913,30102.0
9022,66,61,18,26,209,208,153,152,184,362,360,31977,5787837.0,31616,32580.0
9023,30,26,9,13,153,152,158,157,136,311,309,24174,3759057.0,23864,24024.75
9024,36,25,10,21,121,120,158,157,157,279,277,19118,2666961.0,18840,19320.75
9025,60,49,19,39,155,154,181,180,164,336,334,28055,4713240.0,27720,28056.0
9026,72,57,26,54,134,133,217,216,242,351,349,29078,5103189.0,28728,30624.75
9027,35,32,11,15,137,136,228,227,183,365,363,31236,5700570.0,30872,33123.75
9028,58,46,15,37,130,129,109,108,93,239,237,14170,1693315.0,13932,14160.75
9029,40,35,14,22,95,94,159,158,87,254,252,15105,1918335.0,14852,16002.0
903,59,49,17,33,131,130,120,119,105,251,249,15720,1972860.0,15470,15624.75
9030,64,50,19,44,209,208,180,179,260,389,387,37620,7317090.0,37232,37635.75
9031,65,55,8,26,121,120,109,108,87,230,228,13189,1516735.0,12960,13110.0
9032,57,43,11,28,102,101,117,116,49,219,217,11934,1306773.0,11716,11880.75
9033,106,87,30,64,344,343,225,224,670,569,567,77400,22020300.0,76832,80655.75
9034,79,68,25,44,227,226,149,148,231,376,374,33823,6358724.0,33448,35156.0
9035,25,22,9,13,197,196,167,166,193,364,362,32899,5987618.0,32536,32942.0
9036,82,64,21,53,186,185,185,184,200,371,369,34410,6383055.0,34040,34224.75
9037,83,67,29,58,236,235,407,406,755,643,641,96052,30880718.0,95410,103040.75
9038,94,80,26,52,175,174,188,187,238,363,361,32900,5971350.0,32538,32760.75
9039,45,37,17,31,294,293,226,225,533,520,518,66444,17275440.0,65925,67340.0
904,61,52,18,33,113,112,147,146,109,260,258,16611,2159430.0,16352,16770.0
9040,77,64,21,44,144,143,210,209,215,354,352,30240,5352480.0,29887,31152.0
9041,71,64,13,23,112,111,168,167,105,280,278,18816,2634240.0,18537,19460.0
9042,40,33,14,24,194,193,140,139,152,334,332,27160,4535720.0,26827,27722.0
9043,42,35,14,24,186,185,110,109,153,296,294,20460,3028080.0,20165,21756.0
9044,82,76,14,24,100,99,147,146,87,247,245,14700,1815450.0,14454,15128.75
9045,61,54,16,28,286,285,143,142,468,429,427,40898,8772621.0,40470,45795.75
9046,71,66,13,21,119,118,86,85,46,205,203,10234,1048985.0,10030,10403.75
9047,66,53,20,44,117,116,131,130,75,248,246,15327,1900548.0,15080,15252.0
9048,85,72,26,49,119,118,206,205,149,325,323,24514,3983525.0,24190,26243.75
9049,62,51,23,42,251,250,332,331,921,583,581,83332,24291278.0,82750,84680.75
905,85,75,32,50,271,270,276,275,531,547,545,74796,20456706.0,74250,74528.75
9050,51,41,14,32,161,160,103,102,118,264,262,16583,2188956.0,16320,17292.0
9051,50,44,14,23,128,127,160,159,155,288,286,20480,2949120.0,20193,20592.0
9052,44,35,15,30,128,127,113,112,82,241,239,14464,1742912.0,14224,14399.75
9053,47,39,8,15,106,105,114,113,81,220,218,12084,1329240.0,11865,11990.0
9054,96,85,29,48,151,150,229,228,270,380,378,34579,6570010.0,34200,35910.0
9056,55,51,20,26,143,142,166,165,186,309,307,23738,3667521.0,23430,23715.75
9057,103,83,31,67,183,182,201,200,294,384,382,36783,7062336.0,36400,36672.0
9058,45,38,17,29,223,222,107,106,149,330,328,23861,3937065.0,23532,27060.0
9059,178,174,12,18,193,192,193,192,272,386,384,37249,7189057.0,36864,37056.0
906,75,54,22,61,145,144,180,179,169,325,323,26100,4241250.0,25776,26243.75
9060,141,114,44,95,297,296,362,361,1226,659,657,107514,35425863.0,106856,108240.75
9061,79,69,23,41,306,305,174,173,494,480,478,53244,12778560.0,52765,57360.0
9063,91,70,28,68,228,227,267,266,535,495,493,60876,15066810.0,60382,61008.75
9064,105,101,10,16,124,123,178,177,113,302,300,22072,3332872.0,21771,22650.0
9065,98,86,28,50,267,266,174,173,443,441,439,46458,10243989.0,46018,48399.75
9066,87,79,24,38,181,180,166,165,317,347,345,30046,5212981.0,29700,29928.75
9067,34,30,11,17,121,120,101,100,53,222,220,12221,1356531.0,12000,12210.0
9068,26,23,10,13,63,62,135,134,35,198,196,8505,841995.0,8308,9702.0
9069,47,43,11,15,146,145,122,121,109,268,266,17812,2386808.0,17545,17822.0
907,53,50,13,17,155,154,143,142,133,298,296,22165,3302585.0,21868,22052.0
9070,41,34,10,22,104,103,158,157,97,262,260,16432,2152592.0,16171,17030.0
9071,61,47,22,48,246,245,157,156,316,403,401,38622,7782333.0,38220,40400.75
9072,153,121,43,102,394,393,379,378,3310,773,771,149326,57714499.0,148554,148995.75
9073,56,47,11,27,119,118,106,105,70,225,223,12614,1419075.0,12390,12543.75
9074,46,41,16,22,135,134,188,187,160,323,321,25380,4098870.0,25058,25920.75
9075,72,59,15,36,99,98,132,131,93,231,229,13068,1509354.0,12838,13224.75
9077,92,82,26,43,258,257,162,161,266,420,418,41796,8777160.0,41377,43890.0
9078,55,44,21,41,168,167,373,372,624,541,539,62664,16950612.0,62124,72899.75
9079,68,54,15,41,98,97,143,142,76,241,239,14014,1688687.0,13774,14399.75
908,29,22,9,19,158,157,220,219,275,378,376,34760,6569640.0,34383,35532.0
9080,64,49,25,51,163,162,211,210,564,374,372,34393,6431491.0,34020,34782.0
9081,63,50,19,42,183,182,147,146,158,330,328,26901,4438665.0,26572,27060.0
9082,76,65,21,41,154,153,154,153,160,308,306,23716,3652264.0,23409,23562.0
9083,57,43,22,48,150,149,148,147,148,298,296,22200,3307800.0,21903,22052.0
9084,50,45,14,21,92,91,107,106,36,199,197,9844,979478.0,9646,9800.75
9085,70,58,27,48,486,485,430,429,2917,916,914,208980,95712840.0,208065,209306.0
9086,71,55,24,50,228,227,284,283,674,512,510,64752,16576512.0,64241,65280.0
9087,25,23,6,8,79,78,192,191,78,271,269,15168,2055264.0,14898,18224.75
9088,46,33,13,37,107,106,141,140,85,248,246,15087,1870788.0,14840,15252.0
9089,37,32,10,18,134,133,118,117,80,252,250,15812,1992312.0,15561,15750.0
909,66,58,15,29,158,157,114,113,102,272,270,18012,2449632.0,17741,18360.0
9090,54,37,10,41,106,105,136,135,81,242,240,14416,1744336.0,14175,14520.0
9091,124,117,19,31,292,291,175,174,428,467,465,51100,11931850.0,50634,54288.75
9092,37,30,12,23,176,175,100,99,109,276,274,17600,2428800.0,17325,18906.0
9093,202,201,15,15,216,215,239,238,481,455,453,51624,11744460.0,51170,51528.75
9094,31,25,7,12,148,147,70,69,48,218,216,10360,1129240.0,10143,11772.0
9095,239,221,40,74,482,481,367,366,3203,849,847,176894,75091503.0,176046,179775.75
9096,60,51,19,34,117,116,189,188,96,306,304,22113,3383289.0,21808,23256.0
9097,50,37,11,34,118,117,92,91,68,210,208,10856,1139880.0,10647,10920.0
9098,76,67,24,39,267,266,286,285,725,553,551,76362,21114093.0,75810,76175.75
9099,40,31,14,29,156,155,192,191,202,348,346,29952,5211648.0,29605,30102.0
91,24,22,7,9,98,97,164,163,76,262,260,16072,2105432.0,15811,17030.0
910,40,32,11,25,196,195,94,93,92,290,288,18424,2671480.0,18135,20880.0
9100,46,39,14,22,211,210,117,116,153,328,326,24687,4048668.0,24360,26732.0
9101,128,108,49,86,239,238,305,304,963,544,542,72895,19827440.0,72352,73712.0
9102,34,31,10,14,72,71,97,96,40,169,167,6984,590148.0,6816,7055.75
9103,24,22,7,9,101,100,80,79,58,181,179,8080,731240.0,7900,8099.75
9104,134,132,10,12,170,169,193,192,235,363,361,32810,5955015.0,32448,32760.75
9105,91,80,28,48,141,140,225,224,224,366,364,31725,5805675.0,31360,33306.0
9106,124,118,11,20,178,177,170,169,204,348,346,30260,5265240.0,29913,30102.0
9107,60,52,17,31,121,120,115,114,49,236,234,13915,1641970.0,13680,13806.0
9108,58,43,10,36,207,206,178,177,270,385,383,36846,7092855.0,36462,36863.75
911,52,43,13,29,167,166,166,165,220,333,331,27722,4615713.0,27390,27555.75
9110,54,37,19,51,226,225,182,181,260,408,406,41132,8390928.0,40725,41412.0
9111,59,46,15,39,107,106,160,159,155,267,265,17120,2285520.0,16854,17688.75
9112,58,47,19,39,206,205,166,165,227,372,370,34196,6360456.0,33825,34410.0
9113,43,41,14,16,124,123,152,151,99,276,274,18848,2601024.0,18573,18906.0
9114,132,104,49,103,270,269,537,536,1854,807,805,144990,58503465.0,144184,162408.75
9115,42,39,16,20,84,83,133,132,43,217,215,11172,1212162.0,10956,11663.75
9116,43,38,13,18,111,110,109,108,45,220,218,12099,1330890.0,11880,11990.0
9117,77,64,17,41,157,156,186,185,258,343,341,29202,5008143.0,28860,29240.75
9118,62,49,18,40,151,150,168,167,173,319,317,25368,4046196.0,25050,25280.75
9119,67,61,20,30,176,175,119,118,154,295,293,20944,3089240.0,20650,21608.75
912,62,47,25,53,369,368,196,195,531,565,563,72324,20431530.0,71760,79523.75
9120,62,52,22,38,213,212,143,142,194,356,354,30459,5421702.0,30104,31506.0
9121,41,32,13,29,90,89,119,118,41,209,207,10710,1119195.0,10502,10815.75
9122,60,53,17,29,163,162,152,151,119,315,313,24776,3902220.0,24462,24648.75
9123,182,161,58,98,527,526,446,445,4600,973,971,235042,114347933.0,234070,236195.75
9124,44,36,15,28,149,148,271,270,318,420,418,40379,8479590.0,39960,43890.0
9125,65,52,21,37,253,252,237,236,393,490,488,59961,14690445.0,59472,59780.0
9126,183,182,11,11,262,261,216,215,491,478,476,56592,13525488.0,56115,56882.0
9127,41,37,15,18,135,134,130,129,101,265,263,17550,2325375.0,17286,17423.75
9128,83,67,20,47,171,170,190,189,206,361,359,32490,5864445.0,32130,32399.75
9129,62,57,17,24,124,123,135,134,69,259,257,16740,2167830.0,16482,16640.75
913,108,85,34,73,258,257,225,224,495,483,481,58050,14019075.0,57568,58080.75
9130,97,90,23,33,204,203,178,177,195,382,380,36312,6935592.0,35931,36290.0
9131,44,31,10,24,117,116,101,100,53,218,216,11817,1288053.0,11600,11772.0
9132,72,64,16,30,148,147,155,154,146,303,301,22940,3475410.0,22638,22800.75
9133,71,58,20,42,139,138,149,148,160,288,286,20711,2982384.0,20424,20592.0
9134,61,52,22,38,175,174,146,145,158,321,319,25550,4100775.0,25230,25599.75
9135,50,40,17,32,179,178,223,222,298,402,400,39917,8023317.0,39516,40200.0
9136,60,43,18,48,223,222,189,188,469,412,410,42147,8682282.0,41736,42230.0
9137,61,46,22,49,151,150,161,160,175,312,310,24311,3792516.0,24000,24180.0
9138,70,58,20,40,171,170,119,118,166,290,288,20349,2950605.0,20060,20880.0
9139,54,49,14,21,89,88,113,112,41,202,200,10057,1015757.0,9856,10100.0
914,36,29,13,25,215,214,202,201,323,417,415,43430,9055155.0,43014,43263.75
9140,81,61,24,62,184,183,199,198,367,383,381,36616,7011964.0,36234,36480.75
9141,63,55,16,30,141,140,219,218,174,360,358,30879,5558220.0,30520,32220.0
9142,41,31,12,26,162,161,178,177,194,340,338,28836,4902120.0,28497,28730.0
9143,62,56,20,30,121,120,168,167,107,289,287,20328,2937396.0,20040,20735.75
9144,68,47,18,56,164,163,134,133,121,298,296,21976,3274424.0,21679,22052.0
9145,43,38,12,19,243,242,202,201,325,445,443,49086,10921635.0,48642,49283.75
9146,31,27,10,15,96,95,183,182,83,279,277,17568,2450736.0,17290,19320.75
9147,51,39,13,34,125,124,155,154,84,280,278,19375,2712500.0,19096,19460.0
9148,53,41,8,30,117,116,111,110,65,228,226,12987,1480518.0,12760,12882.0
9149,95,81,30,54,190,189,159,158,254,349,347,30210,5271645.0,29862,30275.75
915,43,36,8,20,138,137,189,188,141,327,325,26082,4264407.0,25756,26568.75
9150,42,37,15,23,213,212,143,142,181,356,354,30459,5421702.0,30104,31506.0
9151,181,149,58,119,388,387,423,422,2152,811,809,164124,66552282.0,163314,164024.75
9152,45,39,10,19,152,151,77,76,59,229,227,11704,1340108.0,11476,12995.75
9153,189,188,12,12,202,201,222,221,421,424,422,44844,9506928.0,44421,44732.0
9154,82,68,19,40,144,143,152,151,109,296,294,21888,3239424.0,21593,21756.0
9155,79,72,20,32,170,169,236,235,412,406,404,40120,8144360.0,39715,41006.0
9156,97,81,24,51,350,349,267,266,980,617,615,93450,28829325.0,92834,94863.75
9157,67,59,15,27,248,247,152,151,389,400,398,37696,7539200.0,37297,39800.0
9158,68,62,18,28,120,119,178,177,139,298,296,21360,3182640.0,21063,22052.0
9159,46,39,13,25,140,139,86,85,83,226,224,12040,1360520.0,11815,12656.0
916,37,32,11,19,74,73,151,150,53,225,223,11174,1257075.0,10950,12543.75
9160,69,65,13,19,124,123,139,138,79,263,261,17236,2266534.0,16974,17160.75
9161,76,65,23,41,203,202,132,131,180,335,333,26796,4488330.0,26462,27888.75
9162,97,70,31,83,185,184,223,222,292,408,406,41255,8416020.0,40848,41412.0
9163,45,37,18,29,219,218,328,327,565,547,545,71832,19646052.0,71286,74528.75
9164,70,56,22,48,384,383,188,187,764,572,570,72192,20646912.0,71621,81510.0
9165,39,37,11,13,111,110,138,137,81,249,247,15318,1907091.0,15070,15375.75
9166,62,48,22,46,344,343,171,170,499,515,513,58824,15147180.0,58310,66048.75
9167,37,31,12,20,98,97,186,185,93,284,282,18228,2588376.0,17945,20022.0
9168,90,67,31,73,267,266,272,271,628,539,537,72624,19572168.0,72086,72360.75
9169,54,47,12,24,224,223,146,145,244,370,368,32704,6050240.0,32335,34040.0
917,138,137,10,10,216,215,147,146,201,363,361,31752,5762988.0,31390,32760.75
9171,58,54,16,22,126,125,138,137,120,264,262,17388,2295216.0,17125,17292.0
9172,80,71,19,34,145,144,142,141,104,287,285,20590,2954665.0,20304,20448.75
9173,76,61,24,50,146,145,204,203,188,350,348,29784,5212200.0,29435,30450.0
9174,25,20,10,18,215,214,132,131,164,347,345,28380,4923930.0,28034,29928.75
9175,43,34,19,35,249,248,138,137,242,387,385,34362,6649047.0,33976,37248.75
9176,57,47,24,41,304,303,359,358,987,663,661,109136,36178584.0,108474,109560.75
9178,99,89,26,44,248,247,160,159,317,408,406,39680,8094720.0,39273,41412.0
9179,48,42,15,24,164,163,91,90,107,255,253,14924,1902810.0,14670,16128.75
918,18,17,5,5,99,98,185,184,98,284,282,18315,2600730.0,18032,20022.0
9180,44,31,14,38,135,134,182,181,162,317,315,24570,3894345.0,24254,24963.75
9181,53,42,19,33,213,212,149,148,238,362,360,31737,5744397.0,31376,32580.0
9182,33,31,8,10,103,102,181,180,109,284,282,18643,2647306.0,18360,20022.0
9183,58,55,18,22,171,170,120,119,127,291,289,20520,2985660.0,20230,21024.75
9184,127,100,30,79,271,270,434,433,1995,705,703,117614,41458935.0,116910,123903.75
9185,63,50,16,40,103,102,116,115,68,219,217,11948,1308306.0,11730,11880.75
9186,257,256,10,10,267,266,267,266,592,534,532,71289,19034163.0,70756,71022.0
9187,47,41,14,23,129,128,289,288,451,418,416,37281,7791729.0,36864,43472.0
9188,120,99,40,79,271,270,326,325,688,597,595,88346,26371281.0,87750,88803.75
9189,61,56,16,23,209,208,101,100,103,310,308,21109,3271895.0,20800,23870.0
919,141,108,44,106,487,486,451,450,4940,938,936,219637,103009753.0,218700,219492.0
9190,103,87,35,64,338,337,346,345,1132,684,682,116948,39996216.0,116265,116622.0
9191,45,37,16,26,239,238,145,144,250,384,382,34655,6653760.0,34272,36672.0
9192,72,68,17,23,203,202,117,116,120,320,318,23751,3800160.0,23432,25440.0
9193,61,54,17,29,142,141,233,232,207,375,373,33086,6203625.0,32712,34968.75
9194,61,53,18,28,150,149,171,170,273,321,319,25650,4116825.0,25330,25599.75
9195,51,39,15,29,170,169,160,159,204,330,328,27200,4488000.0,26871,27060.0
9196,83,68,31,54,305,304,204,203,537,509,507,62220,15834990.0,61712,64515.75
9197,44,38,14,24,91,90,114,113,58,205,203,10374,1063335.0,10170,10403.75
9198,63,58,16,22,184,183,120,119,213,304,302,22080,3356160.0,21777,22952.0
9199,32,28,11,15,274,273,230,229,549,504,502,63020,15881040.0,62517,63252.0
92,59,49,25,43,216,215,96,95,154,312,310,20736,3234816.0,20425,24180.0
920,60,50,21,36,277,276,144,143,358,421,419,39888,8396424.0,39468,44099.75
9200,68,53,22,47,161,160,314,313,560,475,473,50554,12006575.0,50080,56168.75
9203,47,44,13,17,153,152,123,122,84,276,274,18819,2597022.0,18544,18906.0
9204,58,48,11,26,262,261,152,151,330,414,412,39824,8243568.0,39411,42642.0
9205,53,44,13,29,113,112,171,170,122,284,282,19323,2743866.0,19040,20022.0
9206,43,35,9,17,156,155,84,83,61,240,238,13104,1572480.0,12865,14280.0
9207,55,44,24,43,411,410,198,197,873,609,607,81378,24779601.0,80770,92415.75
9208,27,25,6,7,106,105,89,88,45,195,193,9434,919815.0,9240,9408.75
9209,50,41,17,33,176,175,155,154,170,331,329,27280,4514840.0,26950,27224.75
921,61,52,16,31,158,157,263,262,276,421,419,41554,8747117.0,41134,44099.75
9210,19,18,6,6,188,187,86,85,112,274,272,16168,2215016.0,15895,18632.0
9211,50,40,19,35,156,155,134,133,115,290,288,20904,3031080.0,20615,20880.0
9212,151,126,41,89,414,413,361,360,2216,775,773,149454,57913425.0,148680,149768.75
9213,73,59,26,50,201,200,239,238,386,440,438,48039,10568580.0,47600,48180.0
9214,60,52,16,26,142,141,205,204,226,347,345,29110,5050585.0,28764,29928.75
9215,76,59,23,50,151,150,165,164,207,316,314,24915,3936570.0,24600,24806.0
9216,63,53,24,41,127,126,192,191,129,319,317,24384,3889248.0,24066,25280.75
9217,70,65,17,25,189,188,160,159,199,349,347,30240,5276880.0,29892,30275.75
9218,46,34,12,34,133,132,179,178,150,312,310,23807,3713892.0,23496,24180.0
9219,38,28,10,27,157,156,156,155,205,313,311,24492,3832998.0,24180,24335.75
922,38,33,12,18,200,199,120,119,188,320,318,24000,3840000.0,23681,25440.0
9220,55,44,20,40,117,116,168,167,113,285,283,19656,2800980.0,19372,20163.75
9221,85,74,22,42,155,154,190,189,189,345,343,29450,5080125.0,29106,29583.75
9222,37,31,9,15,97,96,145,144,71,242,240,14065,1701865.0,13824,14520.0
9223,69,61,19,31,264,263,144,143,311,408,406,38016,7755264.0,37609,41412.0
9224,27,21,7,13,188,187,146,145,182,334,332,27448,4583816.0,27115,27722.0
9225,35,28,12,20,103,102,104,103,61,207,205,10712,1108692.0,10506,10608.75
9226,59,48,19,36,209,208,149,148,184,358,356,31141,5574239.0,30784,31862.0
9227,114,113,6,6,170,169,124,123,113,294,292,21080,3098760.0,20787,21462.0
9228,71,64,17,28,112,111,158,157,86,270,268,17696,2388960.0,17427,18090.0
9229,100,86,32,55,216,215,270,269,459,486,484,58320,14171760.0,57835,58806.0
923,73,61,22,40,202,201,205,204,331,407,405,41410,8426935.0,41004,41208.75
9231,75,68,17,29,227,226,137,136,202,364,362,31099,5660018.0,30736,32942.0
9232,56,37,16,48,135,134,186,185,202,321,319,25110,4030155.0,24790,25599.75
9233,58,48,14,31,112,111,192,191,122,304,302,21504,3268608.0,21201,22952.0
9234,62,53,22,35,268,267,201,200,301,469,467,53868,12632046.0,53400,54755.75
9235,64,51,18,40,144,143,171,170,143,315,313,24624,3878280.0,24310,24648.75
9236,62,58,17,23,112,111,175,174,134,287,285,19600,2812600.0,19314,20448.75
9237,41,36,13,19,256,255,150,149,285,406,404,38400,7795200.0,37995,41006.0
9238,71,59,19,41,176,175,109,108,103,285,283,19184,2733720.0,18900,20163.75
9239,42,35,11,23,206,205,138,137,194,344,342,28428,4889616.0,28085,29412.0
924,45,40,17,24,165,164,239,238,244,404,402,39435,7965870.0,39032,40602.0
9240,60,45,22,49,203,202,260,259,579,463,461,52780,12218570.0,52318,53360.75
9241,144,127,28,60,177,176,214,213,228,391,389,37878,7405149.0,37488,38024.75
9242,40,35,13,20,220,219,103,102,126,323,321,22660,3659590.0,22338,25920.75
9243,57,49,22,35,189,188,134,133,157,323,321,25326,4090149.0,25004,25920.75
9244,94,70,25,69,271,270,291,290,820,562,560,78861,22159941.0,78300,78680.0
9245,68,50,17,51,155,154,136,135,185,291,289,21080,3067140.0,20790,21024.75
9246,37,29,12,25,164,163,119,118,104,283,281,19516,2761514.0,19234,19880.75
9247,60,42,12,42,481,480,200,199,1120,681,679,96200,32756100.0,95520,115599.75
9248,83,75,20,31,158,157,129,128,99,287,285,20382,2924817.0,20096,20448.75
9249,63,49,19,39,149,148,181,180,177,330,328,26969,4449885.0,26640,27060.0
925,61,45,16,46,144,143,159,158,183,303,301,22896,3468744.0,22594,22800.75
9250,89,76,31,54,401,400,228,227,1102,629,627,91428,28754106.0,90800,98595.75
9251,40,30,11,26,93,92,111,110,56,204,202,10323,1052946.0,10120,10302.0
9252,72,51,23,62,198,197,127,126,149,325,323,25146,4086225.0,24822,26243.75
9253,71,54,22,50,229,228,249,248,448,478,476,57021,13628019.0,56544,56882.0
9254,52,45,19,30,142,141,157,156,114,299,297,22294,3332953.0,21996,22200.75
9255,56,44,13,35,208,207,124,123,193,332,330,25792,4281472.0,25461,27390.0
9256,56,38,15,48,132,131,164,163,162,296,294,21648,3203904.0,21353,21756.0
9257,39,33,6,13,132,131,103,102,72,235,233,13596,1597530.0,13362,13688.75
9259,72,55,16,46,232,231,121,120,169,353,351,28072,4954708.0,27720,30975.75
926,62,50,21,43,230,229,437,436,868,667,665,100510,33520085.0,99844,110888.75
9260,40,35,8,16,73,72,94,93,24,167,165,6862,572977.0,6696,6888.75
9261,118,117,7,7,239,238,124,123,161,363,361,29636,5378934.0,29274,32760.75
9262,89,80,30,46,223,222,184,183,240,407,405,41032,8350012.0,40626,41208.75
9263,73,64,19,33,187,186,182,181,220,369,367,34034,6279273.0,33666,33855.75
9264,57,44,15,39,91,90,190,189,123,281,279,17290,2429245.0,17010,19599.75
9265,35,29,10,18,154,153,117,116,93,271,269,18018,2441439.0,17748,18224.75
9266,77,59,17,48,167,166,177,176,244,344,342,29559,5084148.0,29216,29412.0
9267,65,51,20,46,159,158,169,168,176,328,326,26871,4406844.0,26544,26732.0
9268,40,35,12,20,147,146,142,141,107,289,287,20874,3016293.0,20586,20735.75
9269,95,81,31,56,207,206,223,222,322,430,428,46161,9924615.0,45732,46010.0
927,72,59,24,48,317,316,339,338,1329,656,654,107463,35247864.0,106808,107256.0
9270,57,52,19,27,165,164,267,266,412,432,430,44055,9515880.0,43624,46440.0
9271,69,61,28,41,183,182,247,246,513,430,428,45201,9718215.0,44772,46010.0
9272,60,46,17,43,154,153,197,196,240,351,349,30338,5324319.0,29988,30624.75
9273,72,54,27,58,417,416,190,189,517,607,605,79230,24046305.0,78624,91808.75
9274,48,44,16,21,112,111,162,161,94,274,272,18144,2485728.0,17871,18632.0
9275,37,28,11,20,148,147,261,260,371,409,407,38628,7899426.0,38220,41615.75
9276,40,34,18,28,157,156,238,237,207,395,393,37366,7379785.0,36972,38808.75
9277,54,48,14,24,114,113,125,124,62,239,237,14250,1702875.0,14012,14160.75
9279,77,67,24,42,135,134,162,161,138,297,295,21870,3247695.0,21574,21903.75
928,69,62,19,30,146,145,228,227,186,374,372,33288,6224856.0,32915,34782.0
9280,71,64,20,32,221,220,157,156,284,378,376,34697,6557733.0,34320,35532.0
9281,56,51,18,26,129,128,116,115,71,245,243,14964,1833090.0,14720,14883.75
9282,65,62,20,24,104,103,235,234,182,339,337,24440,4142580.0,24102,28560.75
9283,125,119,12,21,170,169,178,177,216,348,346,30260,5265240.0,29913,30102.0
9284,27,20,5,12,120,119,148,147,162,268,266,17760,2379840.0,17493,17822.0
9285,57,52,16,24,170,169,190,189,191,360,358,32300,5814000.0,31941,32220.0
9286,48,34,14,37,130,129,147,146,148,277,275,19110,2646735.0,18834,19043.75
9287,47,42,13,20,177,176,95,94,113,272,270,16815,2286840.0,16544,18360.0
9288,110,80,27,84,212,211,211,210,307,423,421,44732,9460818.0,44310,44520.75
9289,82,65,24,55,272,271,195,194,375,467,465,53040,12384840.0,52574,54288.75
929,85,66,18,54,177,176,267,266,485,444,442,47259,10491498.0,46816,49062.0
9291,65,49,21,49,246,245,191,190,464,437,435,46986,10266441.0,46550,47523.75
9292,49,42,18,30,251,250,222,221,568,473,471,55722,13178253.0,55250,55695.75
9293,78,67,21,40,208,207,179,178,284,387,385,37232,7204392.0,36846,37248.75
9294,90,81,25,41,165,164,206,205,243,371,369,33990,6305145.0,33620,34224.75
9295,131,110,43,83,214,213,377,376,761,591,589,80678,23840349.0,80088,87024.75
9296,49,45,16,21,190,189,104,103,115,294,292,19760,2904720.0,19467,21462.0
9297,67,60,14,26,95,94,161,160,81,256,254,15295,1957760.0,15040,16256.0
9298,107,88,38,74,298,297,285,284,644,583,581,84930,24757095.0,84348,84680.75
9299,68,57,17,36,425,424,237,236,1599,662,660,100725,33339975.0,100064,109230.0
93,44,26,14,47,191,190,264,263,399,455,453,50424,11471460.0,49970,51528.75
930,79,67,17,37,252,251,199,198,272,451,449,50148,11308374.0,49698,50624.75
9300,22,20,4,6,137,136,158,157,163,295,293,21646,3192785.0,21352,21608.75
9301,66,58,15,28,283,282,114,113,186,397,395,32262,6404007.0,31866,39203.75
9302,54,43,18,35,132,131,165,164,134,297,295,21780,3234330.0,21484,21903.75
9303,61,57,18,24,153,152,220,219,291,373,371,33660,6277590.0,33288,34595.75
9304,112,107,11,18,262,261,178,177,366,440,438,46636,10259920.0,46197,48180.0
9305,119,118,6,6,170,169,124,123,109,294,292,21080,3098760.0,20787,21462.0
9306,56,48,12,23,105,104,102,101,57,207,205,10710,1108485.0,10504,10608.75
9307,53,39,20,46,185,184,153,152,183,338,336,28305,4783545.0,27968,28392.0
9308,41,38,12,16,199,198,98,97,118,297,295,19502,2896047.0,19206,21903.75
9309,85,70,22,50,187,186,184,183,215,371,369,34408,6382684.0,34038,34224.75
931,47,39,15,29,128,127,204,203,130,332,330,26112,4334592.0,25781,27390.0
9310,34,31,8,11,63,62,154,153,43,217,215,9702,1052667.0,9486,11663.75
9311,44,32,10,25,110,109,111,110,67,221,219,12210,1349205.0,11990,12099.75
9312,40,37,12,16,302,301,223,222,552,525,523,67346,17678325.0,66822,68643.75
9313,74,66,20,33,181,180,148,147,149,329,327,26788,4406626.0,26460,26895.75
9314,28,24,11,16,139,138,90,89,78,229,227,12510,1432395.0,12282,12995.75
9315,49,44,12,20,189,188,117,116,115,306,304,22113,3383289.0,21808,23256.0
9316,86,75,27,47,246,245,302,301,662,548,546,74292,20356008.0,73745,74802.0
9317,65,52,19,42,149,148,120,119,105,269,267,17880,2404860.0,17612,17955.75
9318,25,23,9,10,268,267,510,509,1895,778,776,136680,53168520.0,135903,150932.0
9319,72,43,21,77,248,247,161,160,336,409,407,39928,8165276.0,39520,41615.75
932,46,35,13,32,101,100,135,134,75,236,234,13635,1608930.0,13400,13806.0
9320,56,52,16,22,133,132,145,144,116,278,276,19285,2680615.0,19008,19182.0
9321,58,51,7,17,172,171,79,78,100,251,249,13588,1705294.0,13338,15624.75
9322,82,71,23,43,173,172,278,277,477,451,449,48094,10845197.0,47644,50624.75
9324,51,41,19,37,190,189,177,176,242,367,365,33630,6171105.0,33264,33488.75
9325,33,32,8,8,92,91,140,139,85,232,230,12880,1494080.0,12649,13340.0
9326,119,104,45,73,452,451,369,368,2995,821,819,166788,68466474.0,165968,168099.75
9327,81,70,22,37,170,169,123,122,132,293,291,20910,3063315.0,20618,21315.75
9328,65,54,21,41,175,174,132,131,111,307,305,23100,3545850.0,22794,23408.75
9329,34,31,11,13,155,154,121,120,101,276,274,18755,2588190.0,18480,18906.0
933,41,37,15,21,232,231,322,321,589,554,552,74704,20693008.0,74151,76452.0
9330,71,60,17,33,128,127,145,144,119,273,271,18560,2533440.0,18288,18495.75
9331,67,55,21,42,324,323,173,172,678,497,495,56052,13928922.0,55556,61503.75
9332,52,46,17,27,297,296,170,169,378,467,465,50490,11789415.0,50024,54288.75
9333,49,48,12,12,100,99,140,139,87,240,238,14000,1680000.0,13761,14280.0
9334,49,38,15,35,133,132,158,157,109,291,289,21014,3057537.0,20724,21024.75
9335,108,79,35,91,231,230,338,337,1042,569,567,78078,22213191.0,77510,80655.75
9336,33,30,6,8,173,172,115,114,96,288,286,19895,2864880.0,19608,20592.0
9337,104,86,29,63,188,187,267,266,526,455,453,50196,11419590.0,49742,51528.75
9338,25,23,7,9,186,185,183,182,235,369,367,34038,6280011.0,33670,33855.75
9339,44,38,14,24,163,162,93,92,86,256,254,15159,1940352.0,14904,16256.0
934,50,36,19,44,120,119,154,153,120,274,272,18480,2531760.0,18207,18632.0
9340,42,34,10,24,87,86,133,132,81,220,218,11571,1272810.0,11352,11990.0
9341,79,53,23,70,448,447,391,390,2465,839,837,175168,73482976.0,174330,175560.75
9342,50,39,15,34,387,386,305,304,1528,692,690,118035,40840110.0,117344,119370.0
9343,84,70,29,54,180,179,220,219,216,400,398,39600,7920000.0,39201,39800.0
9345,26,25,8,8,147,146,187,186,210,334,332,27489,4590663.0,27156,27722.0
9346,53,46,16,27,151,150,191,190,178,342,340,28841,4931811.0,28500,29070.0
9347,105,80,31,75,235,234,243,242,573,478,476,57105,13648095.0,56628,56882.0
9348,53,39,15,40,139,138,133,132,116,272,270,18487,2514232.0,18216,18360.0
9349,26,25,5,5,142,141,102,101,68,244,242,14484,1767048.0,14241,14762.0
9350,56,53,14,18,134,133,151,150,99,285,283,20234,2883345.0,19950,20163.75
9351,88,68,31,69,265,264,197,196,358,462,460,52205,12059355.0,51744,53130.0
9352,32,22,6,22,117,116,118,117,105,235,233,13806,1622205.0,13572,13688.75
9353,77,62,25,52,282,281,296,295,808,578,576,83472,24123408.0,82895,83232.0
9354,353,336,21,53,377,376,405,404,2429,782,780,152685,59699835.0,151904,152490.0
9355,65,54,24,44,138,137,186,185,172,324,322,25668,4158216.0,25345,26082.0
9356,68,59,18,34,169,168,138,137,156,307,305,23322,3579927.0,23016,23408.75
9357,47,41,13,19,174,173,101,100,86,275,273,17574,2416425.0,17300,18768.75
9358,34,28,12,22,152,151,114,113,97,266,264,17328,2304624.0,17063,17556.0
9359,85,53,26,85,254,253,442,441,1552,696,694,112268,39069264.0,111573,120756.0
936,84,68,26,56,157,156,146,145,163,303,301,22922,3472683.0,22620,22800.75
9360,52,39,13,36,162,161,115,114,109,277,275,18630,2580255.0,18354,19043.75
9361,110,90,41,78,258,257,293,292,562,551,549,75594,20826147.0,75044,75624.75
9362,39,31,11,21,148,147,187,186,189,335,333,27676,4635730.0,27342,27888.75
9363,72,57,28,54,317,316,187,186,625,504,502,59279,14938308.0,58776,63252.0
9364,126,104,31,70,289,288,268,267,900,557,555,77452,21570382.0,76896,77283.75
9365,65,54,13,32,179,178,111,110,135,290,288,19869,2881005.0,19580,20880.0
9366,38,33,10,17,139,138,125,124,93,264,262,17375,2293500.0,17112,17292.0
9367,44,37,15,25,145,144,131,130,114,276,274,18995,2621310.0,18720,18906.0
9368,31,26,8,16,103,102,130,129,78,233,231,13390,1559935.0,13158,13455.75
9369,41,37,13,19,102,101,85,84,39,187,185,8670,810645.0,8484,8648.75
937,79,74,19,26,194,193,205,204,200,399,397,39770,7934115.0,39372,39600.75
9370,47,43,15,21,191,190,126,125,141,317,315,24066,3814461.0,23750,24963.75
9372,40,33,14,26,96,95,171,170,125,267,265,16416,2191536.0,16150,17688.75
9373,37,31,16,26,179,178,212,211,244,391,389,37948,7418834.0,37558,38024.75
9374,97,87,24,41,171,170,181,180,157,352,350,30951,5447376.0,30600,30800.0
9375,37,31,10,17,182,181,209,208,201,391,389,38038,7436429.0,37648,38024.75
9376,47,38,10,26,123,122,82,81,67,205,203,10086,1033815.0,9882,10403.75
9377,41,34,10,17,106,105,175,174,111,281,279,18550,2606275.0,18270,19599.75
9378,132,109,22,66,213,212,217,216,362,430,428,46221,9937515.0,45792,46010.0
9379,128,119,13,29,178,177,170,169,273,348,346,30260,5265240.0,29913,30102.0
938,28,25,10,14,295,294,142,141,310,437,435,41890,9152965.0,41454,47523.75
9380,75,62,24,48,272,271,169,168,294,441,439,45968,10135944.0,45528,48399.75
9381,80,65,20,45,216,215,163,162,274,379,377,35208,6671916.0,34830,35720.75
9382,40,38,9,11,191,190,115,114,172,306,304,21965,3360645.0,21660,23256.0
9383,33,28,9,14,96,95,125,124,51,221,219,12000,1326000.0,11780,12099.75
9384,97,90,22,34,189,188,144,143,197,333,331,27216,4531464.0,26884,27555.75
9385,88,71,32,61,369,368,491,490,2833,860,858,181179,77906970.0,180320,184470.0
9386,41,38,14,17,184,183,160,159,159,344,342,29440,5063680.0,29097,29412.0
9387,72,63,15,30,179,178,135,134,142,314,312,24165,3793905.0,23852,24492.0
9388,49,39,16,31,115,114,121,120,106,236,234,13915,1641970.0,13680,13806.0
9389,57,55,13,15,160,159,189,188,153,349,347,30240,5276880.0,29892,30275.75
939,44,39,16,22,112,111,133,132,87,245,243,14896,1824760.0,14652,14883.75
9390,68,66,17,19,112,111,182,181,118,294,292,20384,2996448.0,20091,21462.0
9391,111,100,40,59,246,245,367,366,807,613,611,90282,27671433.0,89670,93635.75
9392,114,87,31,83,224,223,233,232,396,457,455,52192,11925872.0,51736,51983.75
9393,66,61,18,24,171,170,206,205,291,377,375,35226,6640101.0,34850,35343.75
9394,48,44,15,20,236,235,173,172,276,409,407,40828,8349326.0,40420,41615.75
9395,50,47,11,15,164,163,73,72,64,237,235,11972,1418682.0,11736,13923.75
9396,67,58,24,40,237,236,424,423,1413,661,659,100488,33211284.0,99828,108899.75
9397,76,68,13,27,105,104,238,237,136,343,341,24990,4285785.0,24648,29240.75
9398,64,53,17,35,127,126,156,155,141,283,281,19812,2803398.0,19530,19880.75
9399,65,57,22,36,154,153,313,312,420,467,465,48202,11255167.0,47736,54288.75
94,65,54,20,36,212,211,161,160,204,373,371,34132,6365618.0,33760,34595.75
940,79,64,24,52,282,281,236,235,713,518,516,66552,17236968.0,66035,66822.0
9400,18,17,4,4,153,152,110,109,91,263,261,16830,2213145.0,16568,17160.75
9401,69,51,23,55,134,133,162,161,139,296,294,21708,3212784.0,21413,21756.0
9402,67,61,18,27,121,120,178,177,140,299,297,21538,3219931.0,21240,22200.75
9403,65,52,23,47,220,219,134,133,196,354,352,29480,5217960.0,29127,31152.0
9404,65,55,22,39,159,158,169,168,140,328,326,26871,4406844.0,26544,26732.0
9405,119,98,36,76,243,242,312,311,586,555,553,75816,21038940.0,75262,76728.75
9406,97,84,32,55,228,227,411,410,913,639,637,93708,29939706.0,93070,101760.75
9407,62,52,22,40,326,325,189,188,605,515,513,61614,15865605.0,61100,66048.75
9408,138,114,35,81,498,497,283,282,1225,781,779,140934,55034727.0,140154,152099.75
9409,76,62,23,48,358,357,283,282,805,641,639,101314,32471137.0,100674,102399.75
941,101,85,33,62,214,213,315,314,567,529,527,67410,17829945.0,66882,69695.75
9410,48,41,15,25,169,168,149,148,178,318,316,25181,4003779.0,24864,25122.0
9411,45,44,11,11,200,199,172,171,182,372,370,34400,6398400.0,34029,34410.0
9412,59,45,23,49,150,149,163,162,177,313,311,24450,3826425.0,24138,24335.75
9413,118,93,34,78,372,371,225,224,740,597,595,83700,24984450.0,83104,88803.75
9414,126,95,39,98,314,313,386,385,1511,700,698,121204,42421400.0,120505,122150.0
9415,64,56,18,31,166,165,147,146,130,313,311,24402,3818913.0,24090,24335.75
9416,56,41,18,40,118,117,160,159,124,278,276,18880,2624320.0,18603,19182.0
9417,54,47,14,26,195,194,100,99,134,295,293,19500,2876250.0,19206,21608.75
9418,59,52,15,27,151,150,102,101,63,253,251,15402,1948353.0,15150,15875.75
9419,32,30,10,12,88,87,124,123,40,212,210,10912,1156672.0,10701,11130.0
942,59,52,18,30,214,213,165,164,218,379,377,35310,6691245.0,34932,35720.75
9420,37,29,11,23,107,106,95,94,50,202,200,10165,1026665.0,9964,10100.0
9421,41,33,15,24,154,153,90,89,62,244,242,13860,1690920.0,13617,14762.0
9422,40,32,15,26,116,115,97,96,43,213,211,11252,1198338.0,11040,11235.75
9423,72,59,21,37,129,128,161,160,135,290,288,20769,3011505.0,20480,20880.0
9424,64,54,24,42,354,353,388,387,1186,742,740,137352,50957592.0,136611,137270.0
9425,32,30,10,11,136,135,361,360,417,497,495,49096,12200356.0,48600,61503.75
9426,90,73,27,59,165,164,180,179,220,345,343,29700,5123250.0,29356,29583.75
9427,19,17,6,7,179,178,289,288,293,468,466,51731,12105054.0,51264,54522.0
9428,74,55,23,55,231,230,274,273,502,505,503,63294,15981735.0,62790,63503.75
9429,94,78,27,57,267,266,187,186,471,454,452,49929,11333883.0,49476,51302.0
943,78,70,11,25,112,111,129,128,84,241,239,14448,1740984.0,14208,14399.75
9430,103,95,36,50,280,279,237,236,536,517,515,66360,17154060.0,65844,66563.75
9431,67,60,21,32,277,276,249,248,745,526,524,68973,18139899.0,68448,68906.0
9432,42,41,8,8,169,168,85,84,74,254,252,14365,1824355.0,14112,16002.0
9434,45,39,16,25,153,152,110,109,101,263,261,16830,2213145.0,16568,17160.75
9435,171,170,7,7,178,177,178,177,202,356,354,31684,5639752.0,31329,31506.0
9436,84,70,22,46,156,155,164,163,162,320,318,25584,4093440.0,25265,25440.0
9437,56,46,16,34,234,233,186,185,422,420,418,43524,9140040.0,43105,43890.0
9438,72,46,21,70,235,234,223,222,572,458,456,52405,12000745.0,51948,52212.0
9439,59,52,15,26,226,225,169,168,214,395,393,38194,7543315.0,37800,38808.75
944,29,28,6,6,94,93,57,56,18,151,149,5358,404529.0,5208,5624.75
9440,71,57,17,41,258,257,177,176,520,435,433,45666,9932355.0,45232,47088.75
9441,72,53,18,47,117,116,162,161,104,279,277,18954,2644083.0,18676,19320.75
9442,89,77,22,44,337,336,359,358,1421,696,694,120983,42102084.0,120288,120756.0
9443,57,47,15,30,109,108,149,148,79,258,256,16241,2095089.0,15984,16512.0
9444,66,58,16,30,224,223,143,142,229,367,365,32032,5877872.0,31666,33488.75
9445,78,65,23,45,171,170,203,202,212,374,372,34713,6491331.0,34340,34782.0
9446,116,96,29,65,230,229,267,266,611,497,495,61410,15260385.0,60914,61503.75
9447,61,54,19,29,191,190,135,134,145,326,324,25785,4202955.0,25460,26406.0
9448,60,56,18,24,244,243,162,161,266,406,404,39528,8024184.0,39123,41006.0
9449,77,70,13,25,96,95,182,181,85,278,276,17472,2428608.0,17195,19182.0
945,28,20,7,18,121,120,119,118,82,240,238,14399,1727880.0,14160,14280.0
9450,302,294,15,29,487,486,323,322,3747,810,808,157301,63706905.0,156492,163620.0
9451,46,41,16,24,85,84,199,198,97,284,282,16915,2401930.0,16632,20022.0
9452,43,39,15,21,137,136,100,99,74,237,235,13700,1623450.0,13464,13923.75
9453,33,26,10,18,108,107,216,215,168,324,322,23328,3779136.0,23005,26082.0
9454,55,47,13,26,137,136,128,127,87,265,263,17536,2323520.0,17272,17423.75
9455,88,77,31,51,237,236,177,176,267,414,412,41949,8683443.0,41536,42642.0
9456,127,108,47,82,450,449,276,275,1227,726,724,124200,45084600.0,123475,131406.0
9457,65,58,14,26,259,258,183,182,313,442,440,47397,10474737.0,46956,48620.0
9458,45,38,16,23,136,135,248,247,238,384,382,33728,6475776.0,33345,36672.0
946,120,116,13,19,147,146,178,177,181,325,323,26166,4251975.0,25842,26243.75
9460,44,39,14,22,167,166,112,111,98,279,277,18704,2609208.0,18426,19320.75
9461,78,71,22,34,213,212,188,187,492,401,399,40044,8028822.0,39644,39999.75
9462,36,31,14,21,135,134,247,246,192,382,380,33345,6368895.0,32964,36290.0
9463,49,41,12,26,97,96,124,123,81,221,219,12028,1329094.0,11808,12099.75
9464,18,17,3,3,180,179,158,157,206,338,336,28440,4806360.0,28103,28392.0
9465,109,83,27,75,194,193,206,205,295,400,398,39964,7992800.0,39565,39800.0
9466,123,121,3,5,147,146,124,123,93,271,269,18228,2469894.0,17958,18224.75
9467,43,35,13,27,172,171,122,121,124,294,292,20984,3084648.0,20691,21462.0
9468,48,39,14,28,143,142,86,85,86,229,227,12298,1408121.0,12070,12995.75
9469,63,53,21,39,179,178,167,166,162,346,344,29893,5171489.0,29548,29756.0
947,55,42,16,37,201,200,184,183,233,385,383,36984,7119420.0,36600,36863.75
9470,31,27,8,14,122,121,115,114,71,237,235,14030,1662555.0,13794,13923.75
9471,34,29,13,20,134,133,84,83,58,218,216,11256,1226904.0,11039,11772.0
9472,140,123,21,53,227,226,182,181,391,409,407,41314,8448713.0,40906,41615.75
9473,47,37,18,35,328,327,233,232,636,561,559,76424,21436932.0,75864,78399.75
9474,116,85,31,91,186,185,292,291,409,478,476,54312,12980568.0,53835,56882.0
9475,50,43,19,31,227,226,184,183,265,411,409,41768,8583324.0,41358,42024.75
9476,78,50,21,68,171,170,288,287,570,459,457,49248,11302416.0,48790,52440.75
9477,47,30,12,41,140,139,106,105,97,246,244,14840,1825320.0,14595,15006.0
9478,50,40,12,30,119,118,84,83,54,203,201,9996,1014594.0,9794,10200.75
9479,40,37,16,20,83,82,118,117,41,201,199,9794,984297.0,9594,9999.75
948,42,33,12,28,107,106,150,149,92,257,255,16050,2062425.0,15794,16383.75
9480,41,36,16,21,265,264,310,309,711,575,573,82150,23618125.0,81576,82368.75
9481,32,29,10,14,154,153,121,120,92,275,273,18634,2562175.0,18360,18768.75
9482,54,47,17,28,193,192,101,100,125,294,292,19493,2865471.0,19200,21462.0
9483,49,41,17,26,140,139,89,88,72,229,227,12460,1426670.0,12232,12995.75
9484,54,40,13,39,130,129,134,133,109,264,262,17420,2299440.0,17157,17292.0
9485,47,39,20,33,190,189,326,325,649,516,514,61940,15980520.0,61425,66306.0
9486,122,117,13,21,147,146,178,177,206,325,323,26166,4251975.0,25842,26243.75
9487,50,42,15,29,141,140,121,120,95,262,260,17061,2234991.0,16800,17030.0
9488,25,22,7,11,74,73,66,65,17,140,138,4884,341880.0,4745,4830.0
9489,71,62,24,37,149,148,184,183,207,333,331,27416,4564764.0,27084,27555.75
949,36,29,12,21,98,97,94,93,44,192,190,9212,884352.0,9021,9120.0
9490,46,38,21,35,381,380,172,171,522,553,551,65532,18119598.0,64980,76175.75
9491,170,121,38,133,410,409,291,290,2967,701,699,119310,41818155.0,118610,122499.75
9492,78,66,21,42,158,157,229,228,277,387,385,36182,7001217.0,35796,37248.75
9493,36,30,15,21,143,142,176,175,176,319,317,25168,4014296.0,24850,25280.75
9495,102,86,28,58,189,188,219,218,388,408,406,41391,8443764.0,40984,41412.0
9496,43,41,11,13,143,142,74,73,57,217,215,10582,1148147.0,10366,11663.75
9497,43,35,15,29,179,178,238,237,337,417,415,42602,8882517.0,42186,43263.75
9498,62,56,19,29,149,148,215,214,179,364,362,32035,5830370.0,31672,32942.0
9499,81,70,23,43,181,180,140,139,149,321,319,25340,4067070.0,25020,25599.75
95,167,139,44,98,492,491,316,315,2312,808,806,155472,62810688.0,154665,162812.0
950,63,31,14,73,197,196,219,218,358,416,414,43143,8973744.0,42728,43056.0
9500,257,256,10,10,267,266,267,266,604,534,532,71289,19034163.0,70756,71022.0
9501,54,43,15,34,93,92,119,118,67,212,210,11067,1173102.0,10856,11130.0
9502,44,35,9,23,125,124,132,131,94,257,255,16500,2120250.0,16244,16383.75
9503,82,71,28,45,227,226,179,178,388,406,404,40633,8248499.0,40228,41006.0
9504,88,81,22,34,230,229,334,333,686,564,562,76820,21663240.0,76257,79242.0
9505,56,51,20,28,188,187,133,132,155,321,319,25004,4013142.0,24684,25599.75
9506,79,67,19,39,131,130,160,159,170,291,289,20960,3049680.0,20670,21024.75
9507,49,41,10,22,126,125,102,101,55,228,226,12852,1465128.0,12625,12882.0
9508,75,61,14,40,142,141,143,142,120,285,283,20306,2893605.0,20022,20163.75
9509,73,63,19,34,342,341,307,306,1237,649,647,104994,34070553.0,104346,104975.75
951,76,65,24,44,163,162,123,122,119,286,284,20049,2867007.0,19764,20306.0
9510,74,60,24,50,205,204,187,186,245,392,390,38335,7513660.0,37944,38220.0
9511,94,87,31,43,366,365,244,243,779,610,608,89304,27237720.0,88695,92720.0
9512,45,40,17,24,231,230,388,387,726,619,617,89628,27739866.0,89010,95480.75
9513,125,98,43,94,315,314,375,374,1000,690,688,118125,40753125.0,117436,118680.0
9514,60,48,16,37,176,175,187,186,326,363,361,32912,5973528.0,32550,32760.75
9516,76,61,21,47,148,147,277,276,521,425,423,40996,8711650.0,40572,44943.75
9517,73,68,14,20,161,160,132,131,112,293,291,21252,3113418.0,20960,21315.75
9518,50,43,17,29,126,125,116,115,63,242,240,14616,1768536.0,14375,14520.0
9519,36,30,10,17,121,120,144,143,97,265,263,17424,2308680.0,17160,17423.75
952,62,47,16,44,124,123,180,179,178,304,302,22320,3392640.0,22017,22952.0
9521,134,117,39,71,263,262,267,266,949,530,528,70221,18608565.0,69692,69960.0
9522,292,285,18,30,426,425,318,317,2393,744,742,135468,50394096.0,134725,138012.0
9523,40,34,14,23,156,155,201,200,183,357,355,31356,5597046.0,31000,31683.75
9524,26,22,6,10,132,131,137,136,102,269,267,18084,2432298.0,17816,17955.75
9525,39,29,9,19,164,163,161,160,193,325,323,26404,4290650.0,26080,26243.75
9526,34,26,14,27,212,211,276,275,447,488,486,58512,14276928.0,58025,59292.0
9527,31,29,7,9,87,86,88,87,32,175,173,7656,669900.0,7482,7568.75
9528,57,48,20,36,141,140,166,165,125,307,305,23406,3592821.0,23100,23408.75
9529,48,43,16,21,127,126,179,178,116,306,304,22733,3478149.0,22428,23256.0
953,79,61,21,52,266,265,187,186,462,453,451,49742,11266563.0,49290,51075.75
9530,63,51,17,37,141,140,225,224,250,366,364,31725,5805675.0,31360,33306.0
9531,119,117,8,10,147,146,216,215,193,363,361,31752,5762988.0,31390,32760.75
9532,40,35,9,14,522,521,423,422,5433,945,943,220806,104330835.0,219862,222783.75
9533,45,33,16,38,123,122,199,198,144,322,320,24477,3940797.0,24156,25760.0
9534,80,72,21,35,190,189,267,266,438,457,455,50730,11591805.0,50274,51983.75
9535,99,86,35,59,269,268,267,266,661,536,534,71823,19248564.0,71288,71556.0
9536,84,68,28,57,311,310,209,208,627,520,518,64999,16899740.0,64480,67340.0
9537,53,45,17,31,175,174,175,174,188,350,348,30625,5359375.0,30276,30450.0
9538,64,58,20,30,258,257,368,367,940,626,624,94944,29717472.0,94319,97656.0
9539,89,77,30,51,247,246,154,153,279,401,399,38038,7626619.0,37638,39999.75
954,155,102,50,152,363,362,363,362,2466,726,724,131769,47832147.0,131044,131406.0
9540,112,95,32,63,162,161,219,218,218,381,379,35478,6758559.0,35098,36099.75
9541,19,18,5,5,164,163,85,84,79,249,247,13940,1735530.0,13692,15375.75
9543,40,35,10,16,100,99,149,148,83,249,247,14900,1855050.0,14652,15375.75
9544,103,79,29,72,278,277,256,255,779,534,532,71168,19001856.0,70635,71022.0
9545,68,57,22,42,207,206,206,205,282,413,411,42642,8805573.0,42230,42435.75
9546,48,44,21,27,285,284,165,164,318,450,448,47025,10580625.0,46576,50400.0
9548,70,56,25,51,244,243,161,160,241,405,403,39284,7955010.0,38880,40803.75
9549,150,121,42,98,254,253,399,398,1086,653,651,101346,33089469.0,100694,106275.75
955,73,57,22,50,138,137,128,127,123,266,264,17664,2349312.0,17399,17556.0
9550,58,47,17,37,124,123,128,127,100,252,250,15872,1999872.0,15621,15750.0
9551,95,76,31,65,199,198,330,329,532,529,527,65670,17369715.0,65142,69695.75
9552,98,81,29,61,393,392,178,177,463,571,569,69954,19971867.0,69384,81224.75
9553,43,40,12,16,93,92,96,95,52,189,187,8928,843696.0,8740,8835.75
9554,21,19,7,9,103,102,111,110,49,214,212,11433,1223331.0,11220,11342.0
9555,73,70,17,21,171,170,131,130,104,302,300,22401,3382551.0,22100,22650.0
9556,52,45,18,30,226,225,116,115,131,342,340,26216,4482936.0,25875,29070.0
9558,35,29,10,16,79,78,165,164,69,244,242,13035,1590270.0,12792,14762.0
956,34,30,11,16,127,126,134,133,76,261,259,17018,2220849.0,16758,16899.75
9560,77,63,22,48,186,185,128,127,172,314,312,23808,3737856.0,23495,24492.0
9561,40,31,11,22,195,194,94,93,107,289,287,18330,2648685.0,18042,20735.75
9562,39,32,12,22,134,133,220,219,189,354,352,29480,5217960.0,29127,31152.0
9563,84,67,31,62,226,225,241,240,405,467,465,54466,12717811.0,54000,54288.75
9564,75,56,18,52,131,130,141,140,120,272,270,18471,2512056.0,18200,18360.0
9565,69,60,20,36,143,142,166,165,188,309,307,23738,3667521.0,23430,23715.75
9566,41,28,13,37,132,131,104,103,61,236,234,13728,1619904.0,13493,13806.0
9567,33,30,10,13,240,239,289,288,477,529,527,69360,18345720.0,68832,69695.75
9568,55,49,14,24,81,80,121,120,49,202,200,9801,989901.0,9600,10100.0
957,74,60,27,53,330,329,176,175,365,506,504,58080,14694240.0,57575,63756.0
9570,54,46,15,26,146,145,103,102,103,249,247,15038,1872231.0,14790,15375.75
9571,66,63,17,21,95,94,146,145,64,241,239,13870,1671335.0,13630,14399.75
9573,81,65,32,62,426,425,300,299,985,726,724,127800,46391400.0,127075,131406.0
9574,74,63,25,45,265,264,233,232,873,498,496,61745,15374505.0,61248,61752.0
9575,49,36,10,33,111,110,96,95,56,207,205,10656,1102896.0,10450,10608.75
9577,105,91,36,60,376,375,428,427,2784,804,802,160928,64693056.0,160125,161202.0
9578,88,74,22,47,250,249,183,182,364,433,431,45750,9904875.0,45318,46655.75
9579,65,58,15,27,100,99,123,122,58,223,221,12300,1371450.0,12078,12320.75
958,36,32,12,18,156,155,88,87,77,244,242,13728,1674816.0,13485,14762.0
9580,84,67,24,55,183,182,352,351,486,535,533,64416,17231280.0,63882,71288.75
9582,104,91,25,49,219,218,267,266,570,486,484,58473,14208939.0,57988,58806.0
9583,42,38,9,15,118,117,177,176,169,295,293,20886,3080685.0,20592,21608.75
9584,112,70,32,110,288,287,360,359,1348,648,646,103680,33592320.0,103033,104652.0
9585,67,46,22,62,226,225,478,477,1056,704,702,108028,38025856.0,107325,123552.0
9586,23,18,7,13,347,346,165,164,467,512,510,57255,14657280.0,56744,65280.0
9587,65,53,18,40,134,133,223,222,252,357,355,29882,5333937.0,29526,31683.75
9588,77,62,31,59,191,190,190,189,208,381,379,36290,6913245.0,35910,36099.75
9589,53,46,17,29,149,148,95,94,66,244,242,14155,1726910.0,13912,14762.0
959,45,36,17,32,126,125,251,250,206,377,375,31626,5961501.0,31250,35343.75
9590,31,17,6,21,124,123,160,159,162,284,282,19840,2817280.0,19557,20022.0
9591,70,57,24,47,181,180,137,136,129,318,316,24797,3942723.0,24480,25122.0
9592,58,49,19,35,185,184,113,112,121,298,296,20905,3114845.0,20608,22052.0
9593,49,44,11,18,113,112,253,252,269,366,364,28589,5231787.0,28224,33306.0
9594,40,33,16,25,148,147,295,294,509,443,441,43660,9670690.0,43218,48840.75
9595,51,44,18,29,155,154,144,143,113,299,297,22320,3336840.0,22022,22200.75
9596,38,37,10,10,104,103,129,128,76,233,231,13416,1562964.0,13184,13455.75
9597,87,63,28,70,262,261,243,242,636,505,503,63666,16075665.0,63162,63503.75
9598,48,43,9,15,139,138,94,93,89,233,231,13066,1522189.0,12834,13455.75
9599,45,38,14,25,130,129,113,112,76,243,241,14690,1784835.0,14448,14640.75
96,39,35,10,16,248,247,153,152,288,401,399,37944,7607772.0,37544,39999.75
960,32,29,11,14,231,230,158,157,256,389,387,36498,7098861.0,36110,37635.75
9600,94,85,33,49,177,176,247,246,317,424,422,43719,9268428.0,43296,44732.0
9601,58,48,20,38,145,144,178,177,127,323,321,25810,4168315.0,25488,25920.75
9602,18,17,5,5,121,120,155,154,97,276,274,18755,2588190.0,18480,18906.0
9603,70,51,26,60,169,168,179,178,178,348,346,30251,5263674.0,29904,30102.0
9604,44,35,17,32,182,181,258,257,319,440,438,46956,10330320.0,46517,48180.0
9605,34,32,10,12,184,183,119,118,118,303,301,21896,3317244.0,21594,22800.75
9606,35,30,13,21,133,132,134,133,85,267,265,17822,2379237.0,17556,17688.75
9607,34,25,8,20,100,99,168,167,145,268,266,16800,2251200.0,16533,17822.0
9608,82,65,21,53,244,243,157,156,286,401,399,38308,7680754.0,37908,39999.75
9609,23,20,7,11,101,100,112,111,58,213,211,11312,1204728.0,11100,11235.75
961,114,90,36,80,346,345,364,363,1441,710,708,125944,44710120.0,125235,125670.0
9610,68,59,13,28,104,103,120,119,74,224,222,12480,1397760.0,12257,12432.0
9611,71,58,24,46,198,197,140,139,160,338,336,27720,4684680.0,27383,28392.0
9612,38,27,10,25,129,128,238,237,284,367,365,30702,5633817.0,30336,33488.75
9613,77,60,32,62,269,268,248,247,790,517,515,66712,17245052.0,66196,66563.75
9614,51,40,13,33,137,136,127,126,110,264,262,17399,2296668.0,17136,17292.0
9615,32,28,9,13,172,171,109,108,89,281,279,18748,2634094.0,18468,19599.75
9616,35,27,12,23,239,238,119,118,171,358,356,28441,5090939.0,28084,31862.0
9617,46,39,13,25,183,182,135,134,180,318,316,24705,3928095.0,24388,25122.0
9618,62,45,15,47,136,135,102,101,95,238,236,13872,1650768.0,13635,14042.0
9619,56,49,16,26,166,165,183,182,186,349,347,30378,5300961.0,30030,30275.75
962,109,88,24,62,366,365,229,228,909,595,593,83814,24934665.0,83220,88208.75
9620,51,43,15,25,111,110,214,213,154,325,323,23754,3860025.0,23430,26243.75
9621,71,61,17,35,113,112,151,150,85,264,262,17063,2252316.0,16800,17292.0
9622,77,63,20,44,152,151,175,174,266,327,325,26600,4349100.0,26274,26568.75
9623,64,45,15,50,165,164,118,117,170,283,281,19470,2755005.0,19188,19880.75
9624,47,36,14,32,149,148,239,238,287,388,386,35611,6908534.0,35224,37442.0
9625,63,52,19,39,171,170,256,255,422,427,425,43776,9346176.0,43350,45368.75
9626,47,38,14,29,206,205,207,206,377,413,411,42642,8805573.0,42230,42435.75
9627,34,30,11,17,275,274,143,142,210,418,416,39325,8218925.0,38908,43472.0
9628,58,44,20,44,297,296,226,225,815,523,521,67122,17552403.0,66600,68120.75
9629,57,46,20,39,214,213,195,194,351,409,407,41730,8533785.0,41322,41615.75
963,76,65,24,43,267,266,238,237,555,505,503,63546,16045365.0,63042,63503.75
9630,63,56,10,20,106,105,108,107,49,214,212,11448,1224936.0,11235,11342.0
9631,20,16,5,9,85,84,96,95,41,181,179,8160,738480.0,7980,8099.75
9632,64,55,23,39,199,198,288,287,428,487,485,57312,13955472.0,56826,59048.75
9633,31,25,9,18,132,131,93,92,66,225,223,12276,1381050.0,12052,12543.75
9635,60,49,20,39,114,113,258,257,215,372,370,29412,5470632.0,29041,34410.0
9636,35,28,8,15,181,180,74,73,66,255,253,13394,1707735.0,13140,16128.75
9637,57,44,17,40,146,145,119,118,95,265,263,17374,2302055.0,17110,17423.75
9638,36,31,14,22,148,147,211,210,176,359,357,31228,5605426.0,30870,32040.75
9639,58,50,18,31,148,147,106,105,86,254,252,15688,1992376.0,15435,16002.0
964,56,46,13,29,147,146,130,129,123,277,275,19110,2646735.0,18834,19043.75
9640,57,54,12,15,138,137,293,292,285,431,429,40434,8713527.0,40004,46224.75
9641,39,31,15,23,105,104,138,137,83,243,241,14490,1760535.0,14248,14640.75
9642,56,50,21,31,119,118,202,201,127,321,319,24038,3858099.0,23718,25599.75
9643,81,60,25,65,194,193,231,230,491,425,423,44814,9522975.0,44390,44943.75
9644,140,118,45,87,295,294,428,427,1238,723,721,126260,45642990.0,125538,130320.75
9645,79,70,26,42,128,127,190,189,148,318,316,24320,3866880.0,24003,25122.0
9646,51,41,17,34,150,149,162,161,177,312,310,24300,3790800.0,23989,24180.0
9647,37,31,12,21,237,236,121,120,226,358,356,28677,5133183.0,28320,31862.0
9648,26,20,6,11,150,149,121,120,107,271,269,18150,2459325.0,17880,18224.75
965,135,113,33,75,294,293,290,289,990,584,582,85260,24895920.0,84677,84972.0
9650,54,44,14,30,121,120,147,146,111,268,266,17787,2383458.0,17520,17822.0
9651,89,66,27,71,174,173,226,225,327,400,398,39324,7864800.0,38925,39800.0
9652,50,40,13,31,245,244,96,95,174,341,339,23520,4010160.0,23180,28899.75
9653,52,42,9,25,120,119,141,140,92,261,259,16920,2208060.0,16660,16899.75
9654,37,33,12,16,247,246,187,186,304,434,432,46189,10023013.0,45756,46872.0
9655,171,170,7,7,178,177,178,177,168,356,354,31684,5639752.0,31329,31506.0
9656,47,41,12,21,74,73,126,125,54,200,198,9324,932400.0,9125,9900.0
9657,26,24,9,10,195,194,187,186,222,382,380,36465,6964815.0,36084,36290.0
9658,50,47,17,21,180,179,259,258,348,439,437,46620,10233090.0,46182,47960.75
9659,42,38,14,17,230,229,259,258,478,489,487,59570,14564865.0,59082,59535.75
966,61,54,15,27,163,162,187,186,247,350,348,30481,5334175.0,30132,30450.0
9660,62,53,15,31,91,90,104,103,39,195,193,9464,922740.0,9270,9408.75
9661,35,29,11,17,161,160,77,76,63,238,236,12397,1475243.0,12160,14042.0
9662,115,94,25,62,209,208,236,235,391,445,443,49324,10974590.0,48880,49283.75
9663,53,39,15,40,146,145,121,120,155,267,265,17666,2358411.0,17400,17688.75
9664,90,70,28,64,298,297,235,234,761,533,531,70030,18662995.0,69498,70755.75
9665,57,47,13,31,96,95,190,189,101,286,284,18240,2608320.0,17955,20306.0
9666,33,31,11,13,80,79,133,132,66,213,211,10640,1133160.0,10428,11235.75
9667,56,45,17,36,148,147,177,176,186,325,323,26196,4256850.0,25872,26243.75
9668,23,20,6,8,110,109,206,205,159,316,314,22660,3580280.0,22345,24806.0
9669,146,140,12,22,245,244,397,396,1347,642,640,97265,31222065.0,96624,102720.0
967,77,66,19,39,106,105,215,214,212,321,319,22790,3657795.0,22470,25599.75
9670,62,49,18,40,165,164,240,239,323,405,403,39600,8019000.0,39196,40803.75
9671,60,48,11,31,161,160,118,117,138,279,277,18998,2650221.0,18720,19320.75
9673,39,29,10,28,347,346,389,388,2053,736,734,134983,49673744.0,134248,135056.0
9674,60,55,15,23,104,103,118,117,70,222,220,12272,1362192.0,12051,12210.0
9675,58,54,19,25,116,115,153,152,156,269,267,17748,2387106.0,17480,17955.75
9676,54,51,12,16,151,150,102,101,91,253,251,15402,1948353.0,15150,15875.75
9677,68,58,16,34,195,194,190,189,296,385,383,37050,7132125.0,36666,36863.75
9679,44,33,12,31,112,111,119,118,72,231,229,13328,1539384.0,13098,13224.75
968,30,24,10,17,94,93,90,89,63,184,182,8460,778320.0,8277,8372.0
9680,50,40,17,35,123,122,126,125,89,249,247,15498,1929501.0,15250,15375.75
9681,50,41,17,33,161,160,147,146,149,308,306,23667,3644718.0,23360,23562.0
9683,55,50,11,19,76,75,114,113,40,190,188,8664,823080.0,8475,8930.0
9684,42,37,13,21,117,116,143,142,109,260,258,16731,2175030.0,16472,16770.0
9685,47,36,17,36,121,120,175,174,125,296,294,21175,3133900.0,20880,21756.0
9686,48,39,13,29,108,107,135,134,75,243,241,14580,1771470.0,14338,14640.75
9687,82,69,22,44,244,243,267,266,686,511,509,65148,16645314.0,64638,65024.75
9688,52,45,16,27,167,166,115,114,111,282,280,19205,2707905.0,18924,19740.0
9689,100,83,34,65,386,385,305,304,1138,691,689,117730,40675715.0,117040,119024.75
969,51,46,16,23,105,104,145,144,98,250,248,15225,1903125.0,14976,15500.0
9690,131,108,42,84,363,362,266,265,732,629,627,96558,30367491.0,95930,98595.75
9692,53,27,14,58,120,119,131,130,123,251,249,15720,1972860.0,15470,15624.75
9693,65,58,16,28,197,196,249,248,343,446,444,49053,10938819.0,48608,49506.0
9694,87,78,19,35,188,187,148,147,192,336,334,27824,4674432.0,27489,28056.0
9695,69,58,23,38,166,165,191,190,240,357,355,31706,5659521.0,31350,31683.75
9696,54,44,15,31,105,104,105,104,52,210,208,11025,1157625.0,10816,10920.0
9697,62,47,16,42,148,147,113,112,133,261,259,16724,2182482.0,16464,16899.75
9698,112,97,26,53,242,241,198,197,389,440,438,47916,10541520.0,47477,48180.0
9699,48,43,14,21,167,166,160,159,140,327,325,26720,4368720.0,26394,26568.75
97,50,39,22,41,321,320,252,251,762,573,571,80892,23175558.0,80320,81795.75
970,78,50,27,78,228,227,268,267,479,496,494,61104,15153792.0,60609,61256.0
9700,56,50,22,32,310,309,208,207,440,518,516,64480,16700320.0,63963,66822.0
9701,71,63,17,30,207,206,189,188,213,396,394,39123,7746354.0,38728,39006.0
9703,66,56,19,30,266,265,255,254,786,521,519,67830,17669715.0,67310,67599.75
9704,70,64,14,22,101,100,135,134,65,236,234,13635,1608930.0,13400,13806.0
9705,42,34,13,25,153,152,137,136,146,290,288,20961,3039345.0,20672,20880.0
9706,91,70,24,63,211,210,227,226,513,438,436,47897,10489443.0,47460,47742.0
9707,73,62,15,34,176,175,178,177,189,354,352,31328,5545056.0,30975,31152.0
9708,110,73,31,99,327,326,301,300,1281,628,626,98427,30906078.0,97800,98282.0
9709,39,34,11,19,155,154,107,106,148,262,260,16585,2172635.0,16324,17030.0
971,55,39,16,34,179,178,174,173,277,353,351,31146,5497269.0,30794,30975.75
9710,50,43,16,27,203,202,115,114,136,318,316,23345,3711855.0,23028,25122.0
9711,49,38,17,34,106,105,178,177,195,284,282,18868,2679256.0,18585,20022.0
9712,54,40,12,36,102,101,106,105,63,208,206,10812,1124448.0,10605,10712.0
9713,52,45,13,21,78,77,165,164,58,243,241,12870,1563705.0,12628,14640.75
9715,48,39,18,34,143,142,144,143,120,287,285,20592,2954952.0,20306,20448.75
9716,74,58,26,52,133,132,157,156,124,290,288,20881,3027745.0,20592,20880.0
9717,52,35,16,46,171,170,154,153,223,325,323,26334,4279275.0,26010,26243.75
9718,51,38,19,42,179,178,228,227,271,407,405,40812,8305242.0,40406,41208.75
9719,37,28,10,19,202,201,168,167,162,370,368,33936,6278160.0,33567,34040.0
972,30,26,12,17,141,140,158,157,163,299,297,22278,3330561.0,21980,22200.75
9720,83,70,18,42,154,153,144,143,126,298,296,22176,3304224.0,21879,22052.0
9721,134,131,10,14,147,146,285,284,279,432,430,41895,9049320.0,41464,46440.0
9722,178,177,0,0,178,177,178,177,237,356,354,31684,5639752.0,31329,31506.0
9723,35,28,10,21,148,147,107,106,137,255,253,15836,2019090.0,15582,16128.75
9724,82,69,24,47,149,148,144,143,153,293,291,21456,3143304.0,21164,21315.75
9725,60,52,20,29,131,130,174,173,138,305,303,22794,3476085.0,22490,23103.75
9727,85,72,20,44,222,221,149,148,273,371,369,33078,6135969.0,32708,34224.75
9728,49,41,13,25,116,115,103,102,54,219,217,11948,1308306.0,11730,11880.75
9729,66,47,21,55,144,143,183,182,210,327,325,26352,4308552.0,26026,26568.75
973,49,45,10,15,108,107,148,147,78,256,254,15984,2045952.0,15729,16256.0
9730,52,35,13,43,161,160,198,197,252,359,357,31878,5722101.0,31520,32040.75
9731,89,71,21,55,183,182,151,150,183,334,332,27633,4614711.0,27300,27722.0
9732,56,49,25,34,149,148,219,218,222,368,366,32631,6004104.0,32264,33672.0
9733,113,96,30,61,177,176,239,238,411,416,414,42303,8799024.0,41888,43056.0
9734,90,73,26,57,226,225,222,221,535,448,446,50172,11238528.0,49725,49952.0
9735,58,52,14,21,102,101,137,136,87,239,237,13974,1669893.0,13736,14160.75
9736,60,52,14,27,170,169,275,274,529,445,443,46750,10401875.0,46306,49283.75
9737,120,96,37,83,313,312,448,447,1537,761,759,140224,53355232.0,139464,144399.75
9738,77,66,19,36,145,144,153,152,156,298,296,22185,3305565.0,21888,22052.0
9739,52,42,10,28,100,99,111,110,61,211,209,11100,1171050.0,10890,11024.75
974,117,94,24,68,332,331,247,246,927,579,577,82004,23740158.0,81426,83520.75
9740,52,42,14,31,142,141,99,98,92,241,239,14058,1693989.0,13818,14399.75
9741,56,47,14,27,108,107,115,114,85,223,221,12420,1384830.0,12198,12320.75
9742,54,49,19,26,248,247,178,177,229,426,424,44144,9402672.0,43719,45156.0
9743,43,34,14,30,144,143,161,160,120,305,303,23184,3535560.0,22880,23103.75
9744,36,31,15,21,142,141,130,129,88,272,270,18460,2510560.0,18189,18360.0
9745,45,33,14,36,197,196,123,122,149,320,318,24231,3876960.0,23912,25440.0
9746,91,70,27,66,218,217,223,222,432,441,439,48614,10719387.0,48174,48399.75
9747,51,45,16,26,130,129,99,98,59,229,227,12870,1473615.0,12642,12995.75
9748,82,68,23,48,224,223,244,243,449,468,466,54656,12789504.0,54189,54522.0
9749,45,33,10,25,128,127,163,162,141,291,289,20864,3035712.0,20574,21024.75
975,61,55,18,28,117,116,115,114,64,232,230,13455,1560780.0,13224,13340.0
9750,49,42,16,27,159,158,99,98,118,258,256,15741,2030589.0,15484,16512.0
9751,106,77,36,87,282,281,237,236,540,519,517,66834,17343423.0,66316,67080.75
9753,35,32,8,12,87,86,163,162,75,250,248,14181,1772625.0,13932,15500.0
9754,61,56,21,26,205,204,212,211,301,417,415,43460,9061410.0,43044,43263.75
9756,68,58,21,39,180,179,131,130,146,311,309,23580,3666690.0,23270,24024.75
9757,138,118,42,80,480,479,400,399,2433,880,878,192000,84480000.0,191121,193160.0
9758,56,51,13,21,206,205,189,188,371,395,393,38934,7689465.0,38540,38808.75
9759,82,80,19,21,186,185,130,129,116,316,314,24180,3820440.0,23865,24806.0
976,74,68,22,32,120,119,144,143,92,264,262,17280,2280960.0,17017,17292.0
9760,41,40,11,11,216,215,133,132,203,349,347,28728,5013036.0,28380,30275.75
9761,36,33,12,16,219,218,174,173,268,393,391,38106,7487829.0,37714,38415.75
9762,37,28,12,27,248,247,112,111,217,360,358,27776,4999680.0,27417,32220.0
9763,37,27,8,26,199,198,323,322,723,522,520,64277,16776297.0,63756,67860.0
9764,47,39,14,28,100,99,161,160,67,261,259,16100,2101050.0,15840,16899.75
9765,45,41,13,19,199,198,77,76,80,276,274,15323,2114574.0,15048,18906.0
9766,92,78,28,54,444,443,272,271,1346,716,714,120768,43234944.0,120053,127806.0
9767,53,49,15,20,168,167,222,221,209,390,388,37296,7272720.0,36907,37830.0
9768,72,59,23,47,153,152,143,142,116,296,294,21879,3238092.0,21584,21756.0
9769,44,38,17,24,145,144,157,156,159,302,300,22765,3437515.0,22464,22650.0
977,93,73,24,62,194,193,155,154,193,349,347,30070,5247215.0,29722,30275.75
9770,40,30,13,26,89,88,110,109,57,199,197,9790,974105.0,9592,9800.75
9771,102,91,31,51,160,159,267,266,342,427,425,42720,9120720.0,42294,45368.75
9772,23,20,8,10,126,125,119,118,74,245,243,14994,1836765.0,14750,14883.75
9773,53,42,15,35,99,98,149,148,83,248,246,14751,1829124.0,14504,15252.0
9774,45,38,14,26,163,162,141,140,131,304,302,22983,3493416.0,22680,22952.0
9775,107,102,10,18,178,177,124,123,120,302,300,22072,3332872.0,21771,22650.0
9776,37,29,10,23,97,96,118,117,112,215,213,11446,1230445.0,11232,11448.75
9777,61,49,18,39,132,131,136,135,107,268,266,17952,2405568.0,17685,17822.0
9778,73,68,21,29,195,194,159,158,203,354,352,31005,5487885.0,30652,31152.0
9779,56,48,17,31,179,178,296,295,410,475,473,52984,12583700.0,52510,56168.75
9780,95,76,30,64,247,246,279,278,567,526,524,68913,18124119.0,68388,68906.0
9782,44,36,16,30,261,260,303,302,759,564,562,79083,22301406.0,78520,79242.0
9783,58,50,12,26,142,141,107,106,80,249,247,15194,1891653.0,14946,15375.75
9784,90,62,28,78,209,208,176,175,315,385,383,36784,7080920.0,36400,36863.75
9785,76,69,20,32,140,139,240,239,244,380,378,33600,6384000.0,33221,35910.0
9786,31,24,11,19,161,160,112,111,91,273,271,18032,2461368.0,17760,18495.75
9787,67,57,23,41,113,112,199,198,126,312,310,22487,3507972.0,22176,24180.0
9788,74,62,24,44,179,178,189,188,242,368,366,33831,6224904.0,33464,33672.0
9789,56,42,16,38,144,143,100,99,76,244,242,14400,1756800.0,14157,14762.0
979,35,29,10,18,125,124,89,88,58,214,212,11125,1190375.0,10912,11342.0
9790,71,63,20,34,185,184,154,153,173,339,337,28490,4829055.0,28152,28560.75
9791,26,24,10,12,176,175,60,59,47,236,234,10560,1246080.0,10325,13806.0
9792,85,72,30,52,195,194,310,309,529,505,503,60450,15263625.0,59946,63503.75
9793,36,31,13,21,319,318,225,224,489,544,542,71775,19522800.0,71232,73712.0
9794,45,34,13,33,116,115,158,157,108,274,272,18328,2510936.0,18055,18632.0
9795,54,44,13,30,117,116,140,139,115,257,255,16380,2104830.0,16124,16383.75
9797,40,30,16,32,267,266,226,225,567,493,491,60342,14874303.0,59850,60515.75
9798,77,62,21,45,119,118,148,147,116,267,265,17612,2351202.0,17346,17688.75
9799,78,68,20,38,150,149,183,182,176,333,331,27450,4570425.0,27118,27555.75
980,36,29,9,21,146,145,80,79,41,226,224,11680,1319840.0,11455,12656.0
9800,52,42,16,31,269,268,219,218,466,488,486,58911,14374284.0,58424,59292.0
9801,36,30,14,24,101,100,181,180,95,282,280,18281,2577621.0,18000,19740.0
9802,45,39,18,28,174,173,188,187,201,362,360,32712,5920872.0,32351,32580.0
9803,86,73,24,48,288,287,355,354,1148,643,641,102240,32870160.0,101598,103040.75
9804,26,23,7,10,105,104,117,116,54,222,220,12285,1363635.0,12064,12210.0
9805,104,82,27,63,409,408,204,203,666,613,611,83436,25573134.0,82824,93635.75
9806,108,94,33,58,189,188,309,308,403,498,496,58401,14541849.0,57904,61752.0
9807,85,74,20,40,153,152,203,202,216,356,354,31059,5528502.0,30704,31506.0
9808,32,31,9,9,201,200,124,123,201,325,323,24924,4050150.0,24600,26243.75
9809,30,22,8,22,266,265,101,100,217,367,365,26866,4929911.0,26500,33488.75
981,68,54,22,48,169,168,131,130,170,300,298,22139,3320850.0,21840,22350.0
9810,46,40,15,24,171,170,102,101,111,273,271,17442,2380833.0,17170,18495.75
9812,119,117,8,10,193,192,124,123,120,317,315,23932,3793222.0,23616,24963.75
9813,52,45,9,20,89,88,111,110,51,200,198,9879,987900.0,9680,9900.0
9814,86,69,25,56,225,224,298,297,417,523,521,67050,17533575.0,66528,68120.75
9815,53,42,14,34,158,157,136,135,136,294,292,21488,3158736.0,21195,21462.0
9816,49,43,12,22,301,300,213,212,666,514,512,64113,16477041.0,63600,65792.0
9817,90,68,27,69,548,547,308,307,1812,856,854,168784,72239552.0,167929,182756.0
9818,49,44,15,23,144,143,139,138,98,283,281,20016,2832264.0,19734,19880.75
9819,42,33,8,20,127,126,71,70,49,198,196,9017,892683.0,8820,9702.0
982,66,56,14,32,110,109,157,156,119,267,265,17270,2305545.0,17004,17688.75
9820,68,67,17,17,191,190,127,126,145,318,316,24257,3856863.0,23940,25122.0
9821,43,40,11,15,185,184,151,150,134,336,334,27935,4693080.0,27600,28056.0
9822,40,36,11,17,81,80,149,148,61,230,228,12069,1387935.0,11840,13110.0
9823,52,42,13,31,168,167,215,214,260,383,381,36120,6916980.0,35738,36480.75
9824,33,24,9,25,92,91,182,181,88,274,272,16744,2293928.0,16471,18632.0
9825,52,37,10,35,90,89,130,129,58,220,218,11700,1287000.0,11481,11990.0
9826,100,88,28,50,257,256,211,210,413,468,466,54227,12689118.0,53760,54522.0
9827,43,36,11,23,124,123,140,139,106,264,262,17360,2291520.0,17097,17292.0
9828,43,37,15,23,218,217,76,75,83,294,292,16568,2435496.0,16275,21462.0
9829,122,117,13,21,178,177,147,146,190,325,323,26166,4251975.0,25842,26243.75
983,34,27,8,14,146,145,91,90,62,237,235,13286,1574391.0,13050,13923.75
9830,95,80,31,56,266,265,216,215,386,482,480,57456,13846896.0,56975,57840.0
9831,62,47,21,47,205,204,209,208,290,414,412,42845,8868915.0,42432,42642.0
9832,47,39,15,29,110,109,153,152,70,263,261,16830,2213145.0,16568,17160.75
9833,64,57,18,30,129,128,133,132,91,262,260,17157,2247567.0,16896,17030.0
9834,50,38,19,40,131,130,141,140,107,272,270,18471,2512056.0,18200,18360.0
9835,37,23,11,37,182,181,321,320,429,503,501,58422,14693133.0,57920,63000.75
9836,48,42,13,22,156,155,163,162,152,319,317,25428,4055766.0,25110,25280.75
9837,83,79,19,24,162,161,282,281,377,444,442,45684,10141848.0,45241,49062.0
9838,56,43,14,32,147,146,123,122,105,270,268,18081,2440935.0,17812,18090.0
9839,82,69,17,41,172,171,165,164,194,337,335,28380,4782030.0,28044,28223.75
984,55,49,13,21,175,174,221,220,293,396,394,38675,7657650.0,38280,39006.0
9840,47,40,14,21,190,189,120,119,131,310,308,22800,3534000.0,22491,23870.0
9841,86,84,15,17,134,133,147,146,221,281,279,19698,2767569.0,19418,19599.75
9842,66,57,23,36,206,205,152,151,185,358,356,31312,5604848.0,30955,31862.0
9843,113,95,33,65,397,396,391,390,1951,788,786,155227,61159438.0,154440,154842.0
9844,86,68,19,53,151,150,173,172,172,324,322,26123,4231926.0,25800,26082.0
9845,141,140,7,7,285,284,147,146,262,432,430,41895,9049320.0,41464,46440.0
9846,132,119,31,51,201,200,224,223,282,425,423,45024,9567600.0,44600,44943.75
9847,69,58,23,43,178,177,333,332,621,511,509,59274,15144507.0,58764,65024.75
9848,38,31,12,24,126,125,156,155,123,282,280,19656,2771496.0,19375,19740.0
9849,41,38,10,13,185,184,111,110,109,296,294,20535,3039180.0,20240,21756.0
985,71,54,25,54,159,158,272,271,333,431,429,43248,9319944.0,42818,46224.75
9850,78,63,21,49,267,266,328,327,808,595,593,87576,26053860.0,86982,88208.75
9851,88,76,16,38,126,125,116,115,133,242,240,14616,1768536.0,14375,14520.0
9853,48,38,14,31,116,115,99,98,69,215,213,11484,1234530.0,11270,11448.75
9854,59,49,13,31,88,87,111,110,59,199,197,9768,971916.0,9570,9800.75
9855,62,55,22,34,238,237,158,157,259,396,394,37604,7445592.0,37209,39006.0
9856,98,67,29,88,487,486,300,299,1641,787,785,146100,57490350.0,145314,154448.75
9857,20,17,5,7,205,204,144,143,198,349,347,29520,5151240.0,29172,30275.75
9858,45,40,12,20,82,81,120,119,50,202,200,9840,993840.0,9639,10100.0
9859,63,46,17,49,184,183,107,106,108,291,289,19688,2864604.0,19398,21024.75
986,48,39,12,28,141,140,152,151,167,293,291,21432,3139788.0,21140,21315.75
9860,141,139,8,10,170,169,147,146,130,317,315,24990,3960915.0,24674,24963.75
9861,83,64,29,64,283,282,318,317,740,601,599,89994,27043197.0,89394,89999.75
9862,123,103,29,67,416,415,267,266,1204,683,681,111072,37931088.0,110390,116280.75
9863,69,61,26,40,484,483,508,507,7423,992,990,245872,121952512.0,244881,245520.0
9865,26,24,8,9,140,139,119,118,98,259,257,16660,2157470.0,16402,16640.75
9866,64,41,19,63,157,156,172,171,187,329,327,27004,4442158.0,26676,26895.75
9867,118,113,11,19,178,177,147,146,190,325,323,26166,4251975.0,25842,26243.75
9868,101,92,29,45,292,291,438,437,980,730,728,127896,46682040.0,127167,132860.0
9869,31,27,10,13,85,84,149,148,62,234,232,12665,1481805.0,12432,13572.0
987,113,87,33,83,239,238,312,311,955,551,549,74568,20543484.0,74018,75624.75
9871,42,35,14,26,123,122,137,136,104,260,258,16851,2190630.0,16592,16770.0
9872,50,41,16,30,248,247,253,252,476,501,499,62744,15717372.0,62244,62499.75
9873,58,50,23,37,200,199,259,258,316,459,457,51800,11888100.0,51342,52440.75
9875,71,64,25,37,154,153,221,220,226,375,373,34034,6381375.0,33660,34968.75
9876,134,115,50,86,325,324,251,250,737,576,574,81575,23493600.0,81000,82656.0
9878,69,48,17,55,253,252,148,147,400,401,399,37444,7507522.0,37044,39999.75
988,119,118,6,6,308,307,124,123,224,432,430,38192,8249472.0,37761,46440.0
9880,91,75,32,60,411,410,305,304,1612,716,714,125355,44877090.0,124640,127806.0
9881,55,47,16,29,154,153,95,94,80,249,247,14630,1821435.0,14382,15375.75
9883,36,34,11,13,206,205,180,179,250,386,384,37080,7156440.0,36695,37056.0
9884,54,41,19,43,190,189,124,123,118,314,312,23560,3698920.0,23247,24492.0
9885,110,92,23,57,142,141,210,209,206,352,350,29820,5248320.0,29469,30800.0
9886,121,105,33,60,218,217,208,207,374,426,424,45344,9658272.0,44919,45156.0
9887,75,59,25,50,237,236,142,141,212,379,377,33654,6377433.0,33276,35720.75
9888,44,39,10,17,114,113,126,125,80,240,238,14364,1723680.0,14125,14280.0
9889,91,76,31,57,191,190,235,234,316,426,424,44885,9560505.0,44460,45156.0
989,59,52,16,28,102,101,146,145,95,248,246,14892,1846608.0,14645,15252.0
9890,24,21,9,12,172,171,165,164,194,337,335,28380,4782030.0,28044,28223.75
9891,71,58,23,46,179,178,157,156,145,336,334,28103,4721304.0,27768,28056.0
9892,55,46,20,32,157,156,200,199,220,357,355,31400,5604900.0,31044,31683.75
9893,20,19,7,7,223,222,249,248,366,472,470,55527,13104372.0,55056,55460.0
9894,78,72,21,28,161,160,262,261,345,423,421,42182,8921493.0,41760,44520.75
9895,47,40,16,26,165,164,349,348,435,514,512,57585,14799345.0,57072,65792.0
9896,40,36,12,18,143,142,239,238,257,382,380,34177,6527807.0,33796,36290.0
9897,108,87,30,66,205,204,299,298,524,504,502,61295,15446340.0,60792,63252.0
9898,96,87,20,36,154,153,220,219,301,374,372,33880,6335560.0,33507,34782.0
9899,101,81,29,67,179,178,246,245,359,425,423,44034,9357225.0,43610,44943.75
99,74,62,23,45,146,145,223,222,202,369,367,32558,6006951.0,32190,33855.75
990,55,44,18,37,138,137,160,159,129,298,296,22080,3289920.0,21783,22052.0
9900,72,68,15,21,109,108,165,164,110,274,272,17985,2463945.0,17712,18632.0
9901,54,48,17,27,144,143,276,275,250,420,418,39744,8346240.0,39325,43890.0
9902,87,79,22,36,181,180,137,136,126,318,316,24797,3942723.0,24480,25122.0
9903,114,93,30,67,216,215,385,384,1890,601,599,83160,24989580.0,82560,89999.75
9904,34,30,10,13,192,191,282,281,354,474,472,54144,12832128.0,53671,55932.0
9905,39,37,13,15,156,155,200,199,203,356,354,31200,5553600.0,30845,31506.0
9906,30,27,11,14,112,111,269,268,231,381,379,30128,5739384.0,29748,36099.75
9907,46,38,16,28,161,160,193,192,152,354,352,31073,5499921.0,30720,31152.0
9908,49,44,11,19,183,182,92,91,93,275,273,16836,2314950.0,16562,18768.75
9909,79,62,22,53,427,426,393,392,7319,820,818,167811,68802510.0,166992,167690.0
991,60,54,15,25,117,116,106,105,56,223,221,12402,1382823.0,12180,12320.75
9910,52,47,19,27,170,169,149,148,137,319,317,25330,4040135.0,25012,25280.75
9911,83,60,21,59,206,205,271,270,463,477,475,55826,13314501.0,55350,56643.75
9912,67,55,22,44,277,276,152,151,348,429,427,42104,9031308.0,41676,45795.75
9913,53,43,20,38,348,347,437,436,1730,785,783,152076,59689830.0,151292,153663.75
9914,57,51,13,23,102,101,117,116,70,219,217,11934,1306773.0,11716,11880.75
9915,41,32,10,19,74,73,89,88,31,163,161,6586,536759.0,6424,6560.75
9916,83,65,23,56,180,179,183,182,194,363,361,32940,5978610.0,32578,32760.75
9917,45,38,11,22,88,87,135,134,78,223,221,11880,1324620.0,11658,12320.75
9918,107,91,28,56,173,172,215,214,341,388,386,37195,7215830.0,36808,37442.0
9919,47,39,15,23,135,134,162,161,141,297,295,21870,3247695.0,21574,21903.75
992,46,39,13,22,336,335,228,227,1034,564,562,76608,21603456.0,76045,79242.0
9920,52,40,12,34,106,105,164,163,99,270,268,17384,2346840.0,17115,18090.0
9921,66,56,18,36,114,113,143,142,101,257,255,16302,2094807.0,16046,16383.75
9922,38,30,14,28,155,154,175,174,144,330,328,27125,4475625.0,26796,27060.0
9923,62,49,19,42,157,156,145,144,159,302,300,22765,3437515.0,22464,22650.0
9924,41,32,12,28,103,102,95,94,35,198,196,9785,968715.0,9588,9702.0
9925,77,51,23,71,202,201,167,166,255,369,367,33734,6223923.0,33366,33855.75
9926,48,39,17,33,152,151,159,158,128,311,309,24168,3758124.0,23858,24024.75
9927,87,71,28,58,209,208,233,232,355,442,440,48697,10762037.0,48256,48620.0
9928,62,50,7,29,121,120,194,193,156,315,313,23474,3697155.0,23160,24648.75
9929,38,30,13,27,129,128,126,125,149,255,253,16254,2072385.0,16000,16128.75
993,39,34,14,22,161,160,120,119,101,281,279,19320,2714460.0,19040,19599.75
9930,40,30,11,24,210,209,126,125,187,336,334,26460,4445280.0,26125,28056.0
9931,78,63,18,41,252,251,205,204,658,457,455,51660,11804310.0,51204,51983.75
9932,90,87,16,20,170,169,142,141,163,312,310,24140,3765840.0,23829,24180.0
9933,62,54,21,35,201,200,139,138,144,340,338,27939,4749630.0,27600,28730.0
9934,36,31,8,16,156,155,108,107,111,264,262,16848,2223936.0,16585,17292.0
9935,78,64,24,50,272,271,164,163,277,436,434,44608,9724544.0,44173,47306.0
9936,44,32,15,33,207,206,208,207,328,415,413,43056,8934120.0,42642,42848.75
9937,44,35,10,22,91,90,132,131,65,223,221,12012,1339338.0,11790,12320.75
9938,59,43,17,47,126,125,117,116,88,243,241,14742,1791153.0,14500,14640.75
9939,40,35,13,20,127,126,104,103,69,231,229,13208,1525524.0,12978,13224.75
994,162,160,11,13,170,169,354,353,576,524,522,60180,15767160.0,59657,68382.0
9940,48,40,11,23,210,209,129,128,153,339,337,27090,4591755.0,26752,28560.75
9941,99,79,31,69,268,267,239,238,434,507,505,64052,16237182.0,63546,64008.75
9942,44,30,12,35,180,179,122,121,154,302,300,21960,3315960.0,21659,22650.0
9943,91,88,13,17,175,174,155,154,290,330,328,27125,4475625.0,26796,27060.0
9944,57,38,20,52,224,223,330,329,806,554,552,73920,20475840.0,73367,76452.0
9945,66,56,19,37,318,317,177,176,565,495,493,56286,13930785.0,55792,61008.75
9946,46,40,15,25,171,170,99,98,99,270,268,16929,2285415.0,16660,18090.0
9947,60,51,21,35,291,290,209,208,504,500,498,60819,15204750.0,60320,62250.0
9949,174,132,57,139,508,507,529,528,7232,1037,1035,268732,139337542.0,267696,268323.75
995,56,48,18,31,104,103,135,134,62,239,237,14040,1677780.0,13802,14160.75
9950,66,51,14,42,142,141,222,221,237,364,362,31524,5737368.0,31161,32942.0
9951,81,57,24,64,209,208,171,170,371,380,378,35739,6790410.0,35360,35910.0
9952,17,16,2,2,95,94,155,154,73,250,248,14725,1840625.0,14476,15500.0
9953,72,62,22,39,287,286,153,152,284,440,438,43911,9660420.0,43472,48180.0
9954,49,43,22,32,174,173,158,157,162,332,330,27492,4563672.0,27161,27390.0
9955,81,67,27,53,288,287,309,308,1010,597,595,88992,26564112.0,88396,88803.75
9956,123,103,37,73,357,356,249,248,878,606,604,88893,26934579.0,88288,91506.0
9957,65,53,15,33,132,131,194,193,189,326,324,25608,4174104.0,25283,26406.0
9958,107,100,24,36,184,183,171,170,222,355,353,31464,5584860.0,31110,31328.75
9959,39,30,13,28,114,113,119,118,77,233,231,13566,1580439.0,13334,13455.75
996,49,40,19,33,210,209,187,186,370,397,395,39270,7795095.0,38874,39203.75
9960,51,47,22,28,132,131,196,195,159,328,326,25872,4243008.0,25545,26732.0
9961,30,27,9,13,128,127,82,81,64,210,208,10496,1102080.0,10287,10920.0
9962,52,37,15,35,215,214,268,267,459,483,481,57620,13915230.0,57138,58080.75
9963,79,67,21,39,172,171,217,216,306,389,387,37324,7259518.0,36936,37635.75
9964,71,60,31,50,204,203,377,376,521,581,579,76908,22341774.0,76328,84099.75
9966,40,34,13,23,105,104,248,247,179,353,351,26040,4596060.0,25688,30975.75
9967,51,44,14,25,85,84,120,119,48,205,203,10200,1045500.0,9996,10403.75
9969,86,73,25,49,153,152,278,277,315,431,429,42534,9166077.0,42104,46224.75
997,32,26,11,21,195,194,146,145,163,341,339,28470,4854135.0,28130,28899.75
9970,56,51,25,32,327,326,201,200,477,528,526,65727,17351928.0,65200,69432.0
9971,81,66,22,49,133,132,175,174,173,308,306,23275,3584350.0,22968,23562.0
9972,32,27,6,12,89,88,90,89,29,179,177,8010,716895.0,7832,7920.75
9973,35,25,9,18,128,127,145,144,136,273,271,18560,2533440.0,18288,18495.75
9974,34,32,9,11,103,102,119,118,61,222,220,12257,1360527.0,12036,12210.0
9975,162,135,50,100,275,274,341,340,769,616,614,93775,28882700.0,93160,94556.0
9976,30,25,11,19,200,199,159,158,172,359,357,31800,5708100.0,31442,32040.75
9977,71,62,17,30,173,172,126,125,144,299,297,21798,3258801.0,21500,22200.75
9978,58,45,22,46,170,169,203,202,237,373,371,34510,6436115.0,34138,34595.75
9979,28,23,7,12,131,130,63,62,47,194,192,8253,800541.0,8060,9312.0
998,106,102,10,16,193,192,178,177,262,371,369,34354,6372667.0,33984,34224.75
9981,44,30,9,34,132,131,108,107,78,240,238,14256,1710720.0,14017,14280.0
9982,52,49,10,14,134,133,164,163,162,298,296,21976,3274424.0,21679,22052.0
9983,41,33,15,28,160,159,103,102,95,263,261,16480,2167120.0,16218,17160.75
9984,109,96,30,54,221,220,165,164,231,386,384,36465,7037745.0,36080,37056.0
9985,111,97,38,63,270,269,548,547,2751,818,816,147960,60515640.0,147143,166872.0
9986,67,56,21,40,257,256,245,244,481,502,500,62965,15804215.0,62464,62750.0
9987,69,43,17,67,149,148,210,209,277,359,357,31290,5616555.0,30932,32040.75
9989,28,24,9,14,89,88,117,116,55,206,204,10413,1072539.0,10208,10506.0
999,63,52,15,35,153,152,101,100,93,254,252,15453,1962531.0,15200,16002.0
9990,73,53,22,59,171,170,169,168,196,340,338,28899,4912830.0,28560,28730.0
9991,35,27,5,19,105,104,124,123,105,229,227,13020,1490790.0,12792,12995.75
9992,68,64,22,28,227,226,177,176,268,404,402,40179,8116158.0,39776,40602.0
9993,168,154,23,49,270,269,238,237,513,508,506,64260,16322040.0,63753,64262.0
9994,48,42,11,20,113,112,108,107,52,221,219,12204,1348542.0,11984,12099.75
9995,80,68,22,44,164,163,222,221,199,386,384,36408,7026744.0,36023,37056.0
9996,161,138,40,84,412,411,290,289,1226,702,700,119480,41937480.0,118779,122850.0
9997,58,52,19,29,133,132,149,148,81,282,280,19817,2794197.0,19536,19740.0
9998,68,58,20,37,122,121,245,244,290,367,365,29890,5484815.0,29524,33488.75
9999,63,52,18,38,111,110,123,122,65,234,232,13653,1597401.0,13420,13572.0
